Experiment,Period,Player ID,Demand,Wholesale p.,Player ID.1,Stock,Sales,Leftovers,Unmet_Demand,Realized_Mfg_Profit,Total_Revenue,Realized_Mfg_Profit_Share,Optimal_Stock,Under/Overstock_wrt_Optimal,Expected Sales,Expected_Leftovers,Expected Retailer Profit,Expected Mfg Profit,Total Expected Revenue,Expected Mfg. Profit Share,Predicted Sales,Predicted Leftovers,Predicted Retailer Profit,Predicted Mfg Profit,Predicted Mfg. Profit Share
1,1,Manufacturer 1,122,8,Retailer 1,60,60,0,62,300,480,0.625,83,-23,59.45544554455446,23.544554455445542,297.2772277227723,415,664,0.625,83,0,415,415,0.625
1,2,Manufacturer 1,144,7,Retailer 1,80,80,0,64,320,560,0.5714285714285714,91,-11,75.39603960396039,15.60396039603961,301.58415841584156,364,637,0.5714285714285714,91,0,364,364,0.5714285714285714
1,3,Manufacturer 1,57,7,Retailer 1,80,57,23,0,320,560,0.5714285714285714,91,-11,75.39603960396039,15.60396039603961,301.58415841584156,364,637,0.5714285714285714,57,34,228,364,0.5714285714285714
1,4,Manufacturer 1,149,9,Retailer 1,51,51,0,98,306,459,0.6666666666666666,75,-24,50.99009900990099,24.009900990099013,305.9405940594059,450,675,0.6666666666666666,75,0,450,450,0.6666666666666666
1,5,Manufacturer 1,135,8,Retailer 1,60,60,0,75,300,480,0.625,83,-23,59.45544554455446,23.544554455445542,297.2772277227723,415,664,0.625,83,0,415,415,0.625
1,6,Manufacturer 1,94,8,Retailer 1,60,60,0,34,300,480,0.625,83,-23,59.45544554455446,23.544554455445542,297.2772277227723,415,664,0.625,83,0,415,415,0.625
1,7,Manufacturer 1,143,11,Retailer 1,0,0,0,143,0,0,0.0,58,-58,0.0,58.0,0.0,464,638,0.7272727272727273,58,0,464,464,0.7272727272727273
1,8,Manufacturer 1,66,9,Retailer 1,51,51,0,15,306,459,0.6666666666666666,75,-24,50.99009900990099,24.009900990099013,305.9405940594059,450,675,0.6666666666666666,66,9,396,450,0.6666666666666666
1,9,Manufacturer 1,123,12,Retailer 1,0,0,0,123,0,0,0.0,50,-50,0.0,50.0,0.0,450,600,0.75,50,0,450,450,0.75
1,10,Manufacturer 1,73,8,Retailer 1,60,60,0,13,300,480,0.625,83,-23,59.45544554455446,23.544554455445542,297.2772277227723,415,664,0.625,73,10,365,415,0.625
1,11,Manufacturer 1,142,9,Retailer 1,51,51,0,91,306,459,0.6666666666666666,75,-24,50.99009900990099,24.009900990099013,305.9405940594059,450,675,0.6666666666666666,75,0,450,450,0.6666666666666666
1,12,Manufacturer 1,132,9,Retailer 1,51,51,0,81,306,459,0.6666666666666666,75,-24,50.99009900990099,24.009900990099013,305.9405940594059,450,675,0.6666666666666666,75,0,450,450,0.6666666666666666
1,13,Manufacturer 1,62,7,Retailer 1,80,62,18,0,320,560,0.5714285714285714,91,-11,75.39603960396039,15.60396039603961,301.58415841584156,364,637,0.5714285714285714,62,29,248,364,0.5714285714285714
1,14,Manufacturer 1,136,9,Retailer 1,51,51,0,85,306,459,0.6666666666666666,75,-24,50.99009900990099,24.009900990099013,305.9405940594059,450,675,0.6666666666666666,75,0,450,450,0.6666666666666666
1,15,Manufacturer 1,146,8,Retailer 1,60,60,0,86,300,480,0.625,83,-23,59.45544554455446,23.544554455445542,297.2772277227723,415,664,0.625,83,0,415,415,0.625
1,16,Manufacturer 1,95,10,Retailer 1,0,0,0,95,0,0,0.0,66,-66,0.0,66.0,0.0,462,660,0.7,66,0,462,462,0.7
1,17,Manufacturer 1,139,6,Retailer 1,115,115,0,24,345,690,0.5,100,15,93.76237623762377,6.237623762376231,281.2871287128713,300,600,0.5,100,0,300,300,0.5
1,18,Manufacturer 1,102,6,Retailer 1,115,102,13,0,345,690,0.5,100,15,93.76237623762377,6.237623762376231,281.2871287128713,300,600,0.5,100,0,300,300,0.5
1,19,Manufacturer 1,83,7,Retailer 1,80,80,0,3,320,560,0.5714285714285714,91,-11,75.39603960396039,15.60396039603961,301.58415841584156,364,637,0.5714285714285714,83,8,332,364,0.5714285714285714
1,20,Manufacturer 1,142,6,Retailer 1,115,115,0,27,345,690,0.5,100,15,93.76237623762377,6.237623762376231,281.2871287128713,300,600,0.5,100,0,300,300,0.5
1,21,Manufacturer 1,80,7,Retailer 1,80,80,0,0,320,560,0.5714285714285714,91,-11,75.39603960396039,15.60396039603961,301.58415841584156,364,637,0.5714285714285714,80,11,320,364,0.5714285714285714
1,22,Manufacturer 1,101,6,Retailer 1,120,101,19,0,360,720,0.5,100,20,95.39603960396039,4.603960396039611,286.18811881188117,300,600,0.5,100,0,300,300,0.5
1,23,Manufacturer 1,113,7,Retailer 1,80,80,0,33,320,560,0.5714285714285714,91,-11,75.39603960396039,15.60396039603961,301.58415841584156,364,637,0.5714285714285714,91,0,364,364,0.5714285714285714
1,24,Manufacturer 1,104,7,Retailer 1,80,80,0,24,320,560,0.5714285714285714,91,-11,75.39603960396039,15.60396039603961,301.58415841584156,364,637,0.5714285714285714,91,0,364,364,0.5714285714285714
1,25,Manufacturer 1,51,7,Retailer 1,80,51,29,0,320,560,0.5714285714285714,91,-11,75.39603960396039,15.60396039603961,301.58415841584156,364,637,0.5714285714285714,51,40,204,364,0.5714285714285714
1,26,Manufacturer 1,76,7,Retailer 1,75,75,0,1,300,525,0.5714285714285714,91,-16,71.78217821782178,19.21782178217822,287.1287128712871,364,637,0.5714285714285714,76,15,304,364,0.5714285714285714
1,27,Manufacturer 1,73,8,Retailer 1,60,60,0,13,300,480,0.625,83,-23,59.45544554455446,23.544554455445542,297.2772277227723,415,664,0.625,73,10,365,415,0.625
1,28,Manufacturer 1,83,9,Retailer 1,51,51,0,32,306,459,0.6666666666666666,75,-24,50.99009900990099,24.009900990099013,305.9405940594059,450,675,0.6666666666666666,75,0,450,450,0.6666666666666666
1,29,Manufacturer 1,147,9,Retailer 1,51,51,0,96,306,459,0.6666666666666666,75,-24,50.99009900990099,24.009900990099013,305.9405940594059,450,675,0.6666666666666666,75,0,450,450,0.6666666666666666
1,30,Manufacturer 1,115,9,Retailer 1,51,51,0,64,306,459,0.6666666666666666,75,-24,50.99009900990099,24.009900990099013,305.9405940594059,450,675,0.6666666666666666,75,0,450,450,0.6666666666666666
1,31,Manufacturer 1,139,8,Retailer 1,60,60,0,79,300,480,0.625,83,-23,59.45544554455446,23.544554455445542,297.2772277227723,415,664,0.625,83,0,415,415,0.625
1,32,Manufacturer 1,59,9,Retailer 1,51,51,0,8,306,459,0.6666666666666666,75,-24,50.99009900990099,24.009900990099013,305.9405940594059,450,675,0.6666666666666666,59,16,354,450,0.6666666666666666
1,33,Manufacturer 1,122,9,Retailer 1,51,51,0,71,306,459,0.6666666666666666,75,-24,50.99009900990099,24.009900990099013,305.9405940594059,450,675,0.6666666666666666,75,0,450,450,0.6666666666666666
1,34,Manufacturer 1,92,9,Retailer 1,51,51,0,41,306,459,0.6666666666666666,75,-24,50.99009900990099,24.009900990099013,305.9405940594059,450,675,0.6666666666666666,75,0,450,450,0.6666666666666666
1,35,Manufacturer 1,93,9,Retailer 1,0,0,0,93,0,0,0.0,75,-75,0.0,75.0,0.0,450,675,0.6666666666666666,75,0,450,450,0.6666666666666666
1,36,Manufacturer 1,136,9,Retailer 1,0,0,0,136,0,0,0.0,75,-75,0.0,75.0,0.0,450,675,0.6666666666666666,75,0,450,450,0.6666666666666666
1,37,Manufacturer 1,116,8,Retailer 1,60,60,0,56,300,480,0.625,83,-23,59.45544554455446,23.544554455445542,297.2772277227723,415,664,0.625,83,0,415,415,0.625
1,38,Manufacturer 1,105,8,Retailer 1,60,60,0,45,300,480,0.625,83,-23,59.45544554455446,23.544554455445542,297.2772277227723,415,664,0.625,83,0,415,415,0.625
1,39,Manufacturer 1,80,8,Retailer 1,60,60,0,20,300,480,0.625,83,-23,59.45544554455446,23.544554455445542,297.2772277227723,415,664,0.625,80,3,400,415,0.625
1,40,Manufacturer 1,75,8,Retailer 1,55,55,0,20,275,440,0.625,83,-28,54.851485148514854,28.148514851485146,274.25742574257424,415,664,0.625,75,8,375,415,0.625
1,1,Manufacturer 2,122,8,Retailer 2,0,0,0,122,0,0,0.0,83,-83,0.0,83.0,0.0,415,664,0.625,83,0,415,415,0.625
1,2,Manufacturer 2,144,8,Retailer 2,80,80,0,64,400,640,0.625,83,-3,75.39603960396039,7.603960396039611,376.98019801980195,415,664,0.625,83,0,415,415,0.625
1,3,Manufacturer 2,57,7,Retailer 2,150,57,93,0,600,1050,0.5714285714285714,91,59,100.0,-9.0,400.0,364,637,0.5714285714285714,57,34,228,364,0.5714285714285714
1,4,Manufacturer 2,149,7,Retailer 2,120,120,0,29,480,840,0.5714285714285714,91,29,95.39603960396039,-4.396039603960389,381.58415841584156,364,637,0.5714285714285714,91,0,364,364,0.5714285714285714
1,5,Manufacturer 2,135,8,Retailer 2,51,51,0,84,255,408,0.625,83,-32,50.99009900990099,32.00990099009901,254.95049504950492,415,664,0.625,83,0,415,415,0.625
1,6,Manufacturer 2,94,8,Retailer 2,90,90,0,4,450,720,0.625,83,7,81.88118811881188,1.1188118811881225,409.4059405940594,415,664,0.625,83,0,415,415,0.625
1,7,Manufacturer 2,143,8,Retailer 2,51,51,0,92,255,408,0.625,83,-32,50.99009900990099,32.00990099009901,254.95049504950492,415,664,0.625,83,0,415,415,0.625
1,8,Manufacturer 2,66,9,Retailer 2,51,51,0,15,306,459,0.6666666666666666,75,-24,50.99009900990099,24.009900990099013,305.9405940594059,450,675,0.6666666666666666,66,9,396,450,0.6666666666666666
1,9,Manufacturer 2,123,8,Retailer 2,110,110,0,13,550,880,0.625,83,27,91.88118811881188,-8.881188118811878,459.4059405940594,415,664,0.625,83,0,415,415,0.625
1,10,Manufacturer 2,73,9,Retailer 2,69,69,0,4,414,621,0.6666666666666666,75,-6,67.11881188118812,7.8811881188118775,402.7128712871287,450,675,0.6666666666666666,73,2,438,450,0.6666666666666666
1,11,Manufacturer 2,142,8,Retailer 2,110,110,0,32,550,880,0.625,83,27,91.88118811881188,-8.881188118811878,459.4059405940594,415,664,0.625,83,0,415,415,0.625
1,12,Manufacturer 2,132,8,Retailer 2,90,90,0,42,450,720,0.625,83,7,81.88118811881188,1.1188118811881225,409.4059405940594,415,664,0.625,83,0,415,415,0.625
1,13,Manufacturer 2,62,9,Retailer 2,80,62,18,0,480,720,0.6666666666666666,75,5,75.39603960396039,-0.3960396039603893,452.37623762376234,450,675,0.6666666666666666,62,13,372,450,0.6666666666666666
1,14,Manufacturer 2,136,9,Retailer 2,0,0,0,136,0,0,0.0,75,-75,0.0,75.0,0.0,450,675,0.6666666666666666,75,0,450,450,0.6666666666666666
1,15,Manufacturer 2,146,8,Retailer 2,100,100,0,46,500,800,0.625,83,17,87.37623762376238,-4.376237623762378,436.8811881188119,415,664,0.625,83,0,415,415,0.625
1,16,Manufacturer 2,95,8,Retailer 2,120,95,25,0,600,960,0.625,83,37,95.39603960396039,-12.39603960396039,476.98019801980195,415,664,0.625,83,0,415,415,0.625
1,17,Manufacturer 2,139,8,Retailer 2,61,61,0,78,305,488,0.625,83,-22,60.34653465346535,22.653465346534652,301.73267326732673,415,664,0.625,83,0,415,415,0.625
1,18,Manufacturer 2,102,8,Retailer 2,75,75,0,27,375,600,0.625,83,-8,71.78217821782178,11.21782178217822,358.9108910891089,415,664,0.625,83,0,415,415,0.625
1,19,Manufacturer 2,83,7,Retailer 2,150,83,67,0,600,1050,0.5714285714285714,91,59,100.0,-9.0,400.0,364,637,0.5714285714285714,83,8,332,364,0.5714285714285714
1,20,Manufacturer 2,142,7,Retailer 2,140,140,0,2,560,980,0.5714285714285714,91,49,99.45544554455445,-8.45544554455445,397.8217821782178,364,637,0.5714285714285714,91,0,364,364,0.5714285714285714
1,21,Manufacturer 2,80,7,Retailer 2,130,80,50,0,520,910,0.5714285714285714,91,39,97.92079207920793,-6.920792079207928,391.6831683168317,364,637,0.5714285714285714,80,11,320,364,0.5714285714285714
1,22,Manufacturer 2,101,7,Retailer 2,130,101,29,0,520,910,0.5714285714285714,91,39,97.92079207920793,-6.920792079207928,391.6831683168317,364,637,0.5714285714285714,91,0,364,364,0.5714285714285714
1,23,Manufacturer 2,113,8,Retailer 2,120,113,7,0,600,960,0.625,83,37,95.39603960396039,-12.39603960396039,476.98019801980195,415,664,0.625,83,0,415,415,0.625
1,24,Manufacturer 2,104,8,Retailer 2,81,81,0,23,405,648,0.625,83,-2,76.08910891089108,6.910891089108915,380.4455445544554,415,664,0.625,83,0,415,415,0.625
1,25,Manufacturer 2,51,8,Retailer 2,71,51,20,0,355,568,0.625,83,-12,68.7128712871287,14.287128712871294,343.5643564356435,415,664,0.625,51,32,255,415,0.625
1,26,Manufacturer 2,76,8,Retailer 2,71,71,0,5,355,568,0.625,83,-12,68.7128712871287,14.287128712871294,343.5643564356435,415,664,0.625,76,7,380,415,0.625
1,27,Manufacturer 2,73,7,Retailer 2,140,73,67,0,560,980,0.5714285714285714,91,49,99.45544554455445,-8.45544554455445,397.8217821782178,364,637,0.5714285714285714,73,18,292,364,0.5714285714285714
1,28,Manufacturer 2,83,7,Retailer 2,120,83,37,0,480,840,0.5714285714285714,91,29,95.39603960396039,-4.396039603960389,381.58415841584156,364,637,0.5714285714285714,83,8,332,364,0.5714285714285714
1,29,Manufacturer 2,147,7,Retailer 2,100,100,0,47,400,700,0.5714285714285714,91,9,87.37623762376238,3.6237623762376217,349.50495049504957,364,637,0.5714285714285714,91,0,364,364,0.5714285714285714
1,30,Manufacturer 2,115,7,Retailer 2,110,110,0,5,440,770,0.5714285714285714,91,19,91.88118811881188,-0.8811881188118775,367.5247524752475,364,637,0.5714285714285714,91,0,364,364,0.5714285714285714
1,31,Manufacturer 2,139,8,Retailer 2,86,86,0,53,430,688,0.625,83,3,79.4059405940594,3.594059405940598,397.029702970297,415,664,0.625,83,0,415,415,0.625
1,32,Manufacturer 2,59,8,Retailer 2,88,59,29,0,440,704,0.625,83,5,80.66336633663366,2.3366336633663423,403.3168316831683,415,664,0.625,59,24,295,415,0.625
1,33,Manufacturer 2,122,8,Retailer 2,71,71,0,51,355,568,0.625,83,-12,68.7128712871287,14.287128712871294,343.5643564356435,415,664,0.625,83,0,415,415,0.625
1,34,Manufacturer 2,92,7,Retailer 2,115,92,23,0,460,805,0.5714285714285714,91,24,93.76237623762377,-2.7623762376237693,375.049504950495,364,637,0.5714285714285714,91,0,364,364,0.5714285714285714
1,35,Manufacturer 2,93,7,Retailer 2,120,93,27,0,480,840,0.5714285714285714,91,29,95.39603960396039,-4.396039603960389,381.58415841584156,364,637,0.5714285714285714,91,0,364,364,0.5714285714285714
1,36,Manufacturer 2,136,7,Retailer 2,110,110,0,26,440,770,0.5714285714285714,91,19,91.88118811881188,-0.8811881188118775,367.5247524752475,364,637,0.5714285714285714,91,0,364,364,0.5714285714285714
1,37,Manufacturer 2,116,7,Retailer 2,105,105,0,11,420,735,0.5714285714285714,91,14,89.75247524752476,1.2475247524752433,359.009900990099,364,637,0.5714285714285714,91,0,364,364,0.5714285714285714
1,38,Manufacturer 2,105,7,Retailer 2,115,105,10,0,460,805,0.5714285714285714,91,24,93.76237623762377,-2.7623762376237693,375.049504950495,364,637,0.5714285714285714,91,0,364,364,0.5714285714285714
1,39,Manufacturer 2,80,7,Retailer 2,110,80,30,0,440,770,0.5714285714285714,91,19,91.88118811881188,-0.8811881188118775,367.5247524752475,364,637,0.5714285714285714,80,11,320,364,0.5714285714285714
1,40,Manufacturer 2,75,7,Retailer 2,100,75,25,0,400,700,0.5714285714285714,91,9,87.37623762376238,3.6237623762376217,349.50495049504957,364,637,0.5714285714285714,75,16,300,364,0.5714285714285714
1,1,Manufacturer 3,122,8,Retailer 3,61,61,0,61,305,488,0.625,83,-22,60.34653465346535,22.653465346534652,301.73267326732673,415,664,0.625,83,0,415,415,0.625
1,2,Manufacturer 3,144,8,Retailer 3,60,60,0,84,300,480,0.625,83,-23,59.45544554455446,23.544554455445542,297.2772277227723,415,664,0.625,83,0,415,415,0.625
1,3,Manufacturer 3,57,8,Retailer 3,59,57,2,0,295,472,0.625,83,-24,58.554455445544555,24.445544554455445,292.7722772277228,415,664,0.625,57,26,285,415,0.625
1,4,Manufacturer 3,149,10,Retailer 3,0,0,0,149,0,0,0.0,66,-66,0.0,66.0,0.0,462,660,0.7,66,0,462,462,0.7
1,5,Manufacturer 3,135,10,Retailer 3,0,0,0,135,0,0,0.0,66,-66,0.0,66.0,0.0,462,660,0.7,66,0,462,462,0.7
1,6,Manufacturer 3,94,9,Retailer 3,0,0,0,94,0,0,0.0,75,-75,0.0,75.0,0.0,450,675,0.6666666666666666,75,0,450,450,0.6666666666666666
1,7,Manufacturer 3,143,10,Retailer 3,0,0,0,143,0,0,0.0,66,-66,0.0,66.0,0.0,462,660,0.7,66,0,462,462,0.7
1,8,Manufacturer 3,66,7,Retailer 3,99,66,33,0,396,693,0.5714285714285714,91,8,86.87128712871286,4.128712871287135,347.48514851485146,364,637,0.5714285714285714,66,25,264,364,0.5714285714285714
1,9,Manufacturer 3,123,7,Retailer 3,113,113,0,10,452,791,0.5714285714285714,91,22,93.03960396039604,-2.039603960396036,372.1584158415842,364,637,0.5714285714285714,91,0,364,364,0.5714285714285714
1,10,Manufacturer 3,73,8,Retailer 3,61,61,0,12,305,488,0.625,83,-22,60.34653465346535,22.653465346534652,301.73267326732673,415,664,0.625,73,10,365,415,0.625
1,11,Manufacturer 3,142,7,Retailer 3,119,119,0,23,476,833,0.5714285714285714,91,28,95.08910891089108,-4.089108910891085,380.3564356435643,364,637,0.5714285714285714,91,0,364,364,0.5714285714285714
1,12,Manufacturer 3,132,8,Retailer 3,65,65,0,67,325,520,0.625,83,-18,63.81188118811881,19.18811881188119,319.05940594059405,415,664,0.625,83,0,415,415,0.625
1,13,Manufacturer 3,62,8,Retailer 3,63,62,1,0,315,504,0.625,83,-20,62.0990099009901,20.900990099009903,310.4950495049505,415,664,0.625,62,21,310,415,0.625
1,14,Manufacturer 3,136,7,Retailer 3,121,121,0,15,484,847,0.5714285714285714,91,30,95.6930693069307,-4.6930693069306955,382.7722772277227,364,637,0.5714285714285714,91,0,364,364,0.5714285714285714
1,15,Manufacturer 3,146,7,Retailer 3,113,113,0,33,452,791,0.5714285714285714,91,22,93.03960396039604,-2.039603960396036,372.1584158415842,364,637,0.5714285714285714,91,0,364,364,0.5714285714285714
1,16,Manufacturer 3,95,7,Retailer 3,109,95,14,0,436,763,0.5714285714285714,91,18,91.47524752475248,-0.47524752475247567,365.9009900990099,364,637,0.5714285714285714,91,0,364,364,0.5714285714285714
1,17,Manufacturer 3,139,7,Retailer 3,123,123,0,16,492,861,0.5714285714285714,91,32,96.25742574257426,-5.257425742574256,385.029702970297,364,637,0.5714285714285714,91,0,364,364,0.5714285714285714
1,18,Manufacturer 3,102,7,Retailer 3,101,101,0,1,404,707,0.5714285714285714,91,10,87.87128712871286,3.128712871287135,351.48514851485146,364,637,0.5714285714285714,91,0,364,364,0.5714285714285714
1,19,Manufacturer 3,83,8,Retailer 3,51,51,0,32,255,408,0.625,83,-32,50.99009900990099,32.00990099009901,254.95049504950492,415,664,0.625,83,0,415,415,0.625
1,20,Manufacturer 3,142,7,Retailer 3,129,129,0,13,516,903,0.5714285714285714,91,38,97.7128712871287,-6.712871287128706,390.8514851485148,364,637,0.5714285714285714,91,0,364,364,0.5714285714285714
1,21,Manufacturer 3,80,8,Retailer 3,61,61,0,19,305,488,0.625,83,-22,60.34653465346535,22.653465346534652,301.73267326732673,415,664,0.625,80,3,400,415,0.625
1,22,Manufacturer 3,101,7,Retailer 3,111,101,10,0,444,777,0.5714285714285714,91,20,92.27722772277228,-1.277227722772281,369.1089108910891,364,637,0.5714285714285714,91,0,364,364,0.5714285714285714
1,23,Manufacturer 3,113,7,Retailer 3,131,113,18,0,524,917,0.5714285714285714,91,40,98.11881188118812,-7.1188118811881225,392.4752475247525,364,637,0.5714285714285714,91,0,364,364,0.5714285714285714
1,24,Manufacturer 3,104,7,Retailer 3,91,91,0,13,364,637,0.5714285714285714,91,0,82.47524752475248,8.524752475247524,329.9009900990099,364,637,0.5714285714285714,91,0,364,364,0.5714285714285714
1,25,Manufacturer 3,51,7,Retailer 3,111,51,60,0,444,777,0.5714285714285714,91,20,92.27722772277228,-1.277227722772281,369.1089108910891,364,637,0.5714285714285714,51,40,204,364,0.5714285714285714
1,26,Manufacturer 3,76,7,Retailer 3,107,76,31,0,428,749,0.5714285714285714,91,16,90.63366336633663,0.3663366336633658,362.5346534653466,364,637,0.5714285714285714,76,15,304,364,0.5714285714285714
1,27,Manufacturer 3,73,7,Retailer 3,135,73,62,0,540,945,0.5714285714285714,91,44,98.81188118811882,-7.811881188118818,395.2475247524753,364,637,0.5714285714285714,73,18,292,364,0.5714285714285714
1,28,Manufacturer 3,83,7,Retailer 3,113,83,30,0,452,791,0.5714285714285714,91,22,93.03960396039604,-2.039603960396036,372.1584158415842,364,637,0.5714285714285714,83,8,332,364,0.5714285714285714
1,29,Manufacturer 3,147,6,Retailer 3,141,141,0,6,423,846,0.5,100,41,99.55445544554455,0.44554455445545216,298.66336633663366,300,600,0.5,100,0,300,300,0.5
1,30,Manufacturer 3,115,7,Retailer 3,103,103,0,12,412,721,0.5714285714285714,91,12,88.83168316831683,2.168316831683171,355.32673267326726,364,637,0.5714285714285714,91,0,364,364,0.5714285714285714
1,31,Manufacturer 3,139,8,Retailer 3,51,51,0,88,255,408,0.625,83,-32,50.99009900990099,32.00990099009901,254.95049504950492,415,664,0.625,83,0,415,415,0.625
1,32,Manufacturer 3,59,7,Retailer 3,93,59,34,0,372,651,0.5714285714285714,91,2,83.63366336633663,7.366336633663366,334.5346534653466,364,637,0.5714285714285714,59,32,236,364,0.5714285714285714
1,33,Manufacturer 3,122,7,Retailer 3,101,101,0,21,404,707,0.5714285714285714,91,10,87.87128712871286,3.128712871287135,351.48514851485146,364,637,0.5714285714285714,91,0,364,364,0.5714285714285714
1,34,Manufacturer 3,92,7,Retailer 3,107,92,15,0,428,749,0.5714285714285714,91,16,90.63366336633663,0.3663366336633658,362.5346534653466,364,637,0.5714285714285714,91,0,364,364,0.5714285714285714
1,35,Manufacturer 3,93,7,Retailer 3,97,93,4,0,388,679,0.5714285714285714,91,6,85.83168316831683,5.168316831683171,343.32673267326726,364,637,0.5714285714285714,91,0,364,364,0.5714285714285714
1,36,Manufacturer 3,136,8,Retailer 3,53,53,0,83,265,424,0.625,83,-30,52.94059405940594,30.05940594059406,264.7029702970297,415,664,0.625,83,0,415,415,0.625
1,37,Manufacturer 3,116,7,Retailer 3,133,116,17,0,532,931,0.5714285714285714,91,42,98.48514851485149,-7.485148514851488,393.94059405940595,364,637,0.5714285714285714,91,0,364,364,0.5714285714285714
1,38,Manufacturer 3,105,7,Retailer 3,127,105,22,0,508,889,0.5714285714285714,91,36,97.26732673267327,-6.2673267326732685,389.0693069306931,364,637,0.5714285714285714,91,0,364,364,0.5714285714285714
1,39,Manufacturer 3,80,7,Retailer 3,0,0,0,80,0,0,0.0,91,-91,0.0,91.0,0.0,364,637,0.5714285714285714,80,11,320,364,0.5714285714285714
1,40,Manufacturer 3,75,10,Retailer 3,0,0,0,75,0,0,0.0,66,-66,0.0,66.0,0.0,462,660,0.7,66,0,462,462,0.7
1,1,Manufacturer 4,122,7,Retailer 4,125,122,3,0,500,875,0.5714285714285714,91,34,96.78217821782178,-5.78217821782178,387.1287128712871,364,637,0.5714285714285714,91,0,364,364,0.5714285714285714
1,2,Manufacturer 4,144,8,Retailer 4,93,93,0,51,465,744,0.625,83,10,83.63366336633663,-0.6336633663366342,418.16831683168317,415,664,0.625,83,0,415,415,0.625
1,3,Manufacturer 4,57,6,Retailer 4,135,57,78,0,405,810,0.5,100,35,98.81188118811882,1.188118811881182,296.43564356435644,300,600,0.5,57,43,171,300,0.5
1,4,Manufacturer 4,149,7,Retailer 4,115,115,0,34,460,805,0.5714285714285714,91,24,93.76237623762377,-2.7623762376237693,375.049504950495,364,637,0.5714285714285714,91,0,364,364,0.5714285714285714
1,5,Manufacturer 4,135,8,Retailer 4,105,105,0,30,525,840,0.625,83,22,89.75247524752476,-6.752475247524757,448.7623762376238,415,664,0.625,83,0,415,415,0.625
1,6,Manufacturer 4,94,8,Retailer 4,70,70,0,24,350,560,0.625,83,-13,67.92079207920793,15.079207920792072,339.6039603960396,415,664,0.625,83,0,415,415,0.625
1,7,Manufacturer 4,143,7,Retailer 4,120,120,0,23,480,840,0.5714285714285714,91,29,95.39603960396039,-4.396039603960389,381.58415841584156,364,637,0.5714285714285714,91,0,364,364,0.5714285714285714
1,8,Manufacturer 4,66,8,Retailer 4,98,66,32,0,490,784,0.625,83,15,86.35643564356435,-3.356435643564353,431.78217821782175,415,664,0.625,66,17,330,415,0.625
1,9,Manufacturer 4,123,6,Retailer 4,137,123,14,0,411,822,0.5,100,37,99.0990099009901,0.9009900990099027,297.2970297029703,300,600,0.5,100,0,300,300,0.5
1,10,Manufacturer 4,73,7,Retailer 4,141,73,68,0,564,987,0.5714285714285714,91,50,99.55445544554455,-8.554455445544548,398.21782178217813,364,637,0.5714285714285714,73,18,292,364,0.5714285714285714
1,11,Manufacturer 4,142,9,Retailer 4,89,89,0,53,534,801,0.6666666666666666,75,14,81.27722772277228,-6.277227722772281,487.6633663366337,450,675,0.6666666666666666,75,0,450,450,0.6666666666666666
1,12,Manufacturer 4,132,8,Retailer 4,99,99,0,33,495,792,0.625,83,16,86.87128712871286,-3.871287128712865,434.35643564356434,415,664,0.625,83,0,415,415,0.625
1,13,Manufacturer 4,62,8,Retailer 4,102,62,40,0,510,816,0.625,83,19,88.35643564356435,-5.356435643564353,441.78217821782175,415,664,0.625,62,21,310,415,0.625
1,14,Manufacturer 4,136,7,Retailer 4,137,136,1,0,548,959,0.5714285714285714,91,46,99.0990099009901,-8.099009900990097,396.39603960396045,364,637,0.5714285714285714,91,0,364,364,0.5714285714285714
1,15,Manufacturer 4,146,7,Retailer 4,110,110,0,36,440,770,0.5714285714285714,91,19,91.88118811881188,-0.8811881188118775,367.5247524752475,364,637,0.5714285714285714,91,0,364,364,0.5714285714285714
1,16,Manufacturer 4,95,8,Retailer 4,95,95,0,0,475,760,0.625,83,12,84.75247524752476,-1.7524752475247567,423.7623762376238,415,664,0.625,83,0,415,415,0.625
1,17,Manufacturer 4,139,8,Retailer 4,128,128,0,11,640,1024,0.625,83,45,97.4950495049505,-14.4950495049505,487.4752475247525,415,664,0.625,83,0,415,415,0.625
1,18,Manufacturer 4,102,9,Retailer 4,68,68,0,34,408,612,0.6666666666666666,75,-7,66.3069306930693,8.693069306930695,397.8415841584158,450,675,0.6666666666666666,75,0,450,450,0.6666666666666666
1,19,Manufacturer 4,83,7,Retailer 4,104,83,21,0,416,728,0.5714285714285714,91,13,89.29702970297029,1.702970297029708,357.1881188118811,364,637,0.5714285714285714,83,8,332,364,0.5714285714285714
1,20,Manufacturer 4,142,8,Retailer 4,87,87,0,55,435,696,0.625,83,4,80.03960396039604,2.960396039603964,400.1980198019802,415,664,0.625,83,0,415,415,0.625
1,21,Manufacturer 4,80,8,Retailer 4,100,80,20,0,500,800,0.625,83,17,87.37623762376238,-4.376237623762378,436.8811881188119,415,664,0.625,80,3,400,415,0.625
1,22,Manufacturer 4,101,7,Retailer 4,115,101,14,0,460,805,0.5714285714285714,91,24,93.76237623762377,-2.7623762376237693,375.049504950495,364,637,0.5714285714285714,91,0,364,364,0.5714285714285714
1,23,Manufacturer 4,113,8,Retailer 4,120,113,7,0,600,960,0.625,83,37,95.39603960396039,-12.39603960396039,476.98019801980195,415,664,0.625,83,0,415,415,0.625
1,24,Manufacturer 4,104,8,Retailer 4,70,70,0,34,350,560,0.625,83,-13,67.92079207920793,15.079207920792072,339.6039603960396,415,664,0.625,83,0,415,415,0.625
1,25,Manufacturer 4,51,7,Retailer 4,95,51,44,0,380,665,0.5714285714285714,91,4,84.75247524752476,6.247524752475243,339.009900990099,364,637,0.5714285714285714,51,40,204,364,0.5714285714285714
1,26,Manufacturer 4,76,6,Retailer 4,150,76,74,0,450,900,0.5,100,50,100.0,0.0,300.0,300,600,0.5,76,24,228,300,0.5
1,27,Manufacturer 4,73,7,Retailer 4,145,73,72,0,580,1015,0.5714285714285714,91,54,99.85148514851485,-8.851485148514854,399.4059405940594,364,637,0.5714285714285714,73,18,292,364,0.5714285714285714
1,28,Manufacturer 4,83,7,Retailer 4,140,83,57,0,560,980,0.5714285714285714,91,49,99.45544554455445,-8.45544554455445,397.8217821782178,364,637,0.5714285714285714,83,8,332,364,0.5714285714285714
1,29,Manufacturer 4,147,8,Retailer 4,120,120,0,27,600,960,0.625,83,37,95.39603960396039,-12.39603960396039,476.98019801980195,415,664,0.625,83,0,415,415,0.625
1,30,Manufacturer 4,115,8,Retailer 4,118,115,3,0,590,944,0.625,83,35,94.77227722772277,-11.772277227722768,473.86138613861385,415,664,0.625,83,0,415,415,0.625
1,31,Manufacturer 4,139,8,Retailer 4,105,105,0,34,525,840,0.625,83,22,89.75247524752476,-6.752475247524757,448.7623762376238,415,664,0.625,83,0,415,415,0.625
1,32,Manufacturer 4,59,9,Retailer 4,0,0,0,59,0,0,0.0,75,-75,0.0,75.0,0.0,450,675,0.6666666666666666,59,16,354,450,0.6666666666666666
1,33,Manufacturer 4,122,8,Retailer 4,86,86,0,36,430,688,0.625,83,3,79.4059405940594,3.594059405940598,397.029702970297,415,664,0.625,83,0,415,415,0.625
1,34,Manufacturer 4,92,8,Retailer 4,67,67,0,25,335,536,0.625,83,-16,65.48514851485149,17.51485148514851,327.42574257425747,415,664,0.625,83,0,415,415,0.625
1,35,Manufacturer 4,93,8,Retailer 4,53,53,0,40,265,424,0.625,83,-30,52.94059405940594,30.05940594059406,264.7029702970297,415,664,0.625,83,0,415,415,0.625
1,36,Manufacturer 4,136,7,Retailer 4,130,130,0,6,520,910,0.5714285714285714,91,39,97.92079207920793,-6.920792079207928,391.6831683168317,364,637,0.5714285714285714,91,0,364,364,0.5714285714285714
1,37,Manufacturer 4,116,8,Retailer 4,95,95,0,21,475,760,0.625,83,12,84.75247524752476,-1.7524752475247567,423.7623762376238,415,664,0.625,83,0,415,415,0.625
1,38,Manufacturer 4,105,8,Retailer 4,88,88,0,17,440,704,0.625,83,5,80.66336633663366,2.3366336633663423,403.3168316831683,415,664,0.625,83,0,415,415,0.625
1,39,Manufacturer 4,80,8,Retailer 4,77,77,0,3,385,616,0.625,83,-6,73.25742574257426,9.742574257425744,366.28712871287127,415,664,0.625,80,3,400,415,0.625
1,40,Manufacturer 4,75,7,Retailer 4,113,75,38,0,452,791,0.5714285714285714,91,22,93.03960396039604,-2.039603960396036,372.1584158415842,364,637,0.5714285714285714,75,16,300,364,0.5714285714285714
2,1,Manufacturer 5,122,9,Retailer 5,0,0,0,122,0,0,0.0,75,-75,0.0,75.0,0.0,450,675,0.6666666666666666,75,0,450,450,0.6666666666666666
2,2,Manufacturer 5,144,8,Retailer 5,80,80,0,64,400,640,0.625,83,-3,75.39603960396039,7.603960396039611,376.98019801980195,415,664,0.625,83,0,415,415,0.625
2,3,Manufacturer 5,57,7,Retailer 5,108,57,51,0,432,756,0.5714285714285714,91,17,91.05940594059406,-0.059405940594061235,364.23762376237624,364,637,0.5714285714285714,57,34,228,364,0.5714285714285714
2,4,Manufacturer 5,149,7,Retailer 5,110,110,0,39,440,770,0.5714285714285714,91,19,91.88118811881188,-0.8811881188118775,367.5247524752475,364,637,0.5714285714285714,91,0,364,364,0.5714285714285714
2,5,Manufacturer 5,135,7,Retailer 5,115,115,0,20,460,805,0.5714285714285714,91,24,93.76237623762377,-2.7623762376237693,375.049504950495,364,637,0.5714285714285714,91,0,364,364,0.5714285714285714
2,6,Manufacturer 5,94,7,Retailer 5,120,94,26,0,480,840,0.5714285714285714,91,29,95.39603960396039,-4.396039603960389,381.58415841584156,364,637,0.5714285714285714,91,0,364,364,0.5714285714285714
2,7,Manufacturer 5,143,7,Retailer 5,115,115,0,28,460,805,0.5714285714285714,91,24,93.76237623762377,-2.7623762376237693,375.049504950495,364,637,0.5714285714285714,91,0,364,364,0.5714285714285714
2,8,Manufacturer 5,66,7,Retailer 5,110,66,44,0,440,770,0.5714285714285714,91,19,91.88118811881188,-0.8811881188118775,367.5247524752475,364,637,0.5714285714285714,66,25,264,364,0.5714285714285714
2,9,Manufacturer 5,123,7,Retailer 5,105,105,0,18,420,735,0.5714285714285714,91,14,89.75247524752476,1.2475247524752433,359.009900990099,364,637,0.5714285714285714,91,0,364,364,0.5714285714285714
2,10,Manufacturer 5,73,7,Retailer 5,100,73,27,0,400,700,0.5714285714285714,91,9,87.37623762376238,3.6237623762376217,349.50495049504957,364,637,0.5714285714285714,73,18,292,364,0.5714285714285714
2,11,Manufacturer 5,142,8,Retailer 5,51,51,0,91,255,408,0.625,83,-32,50.99009900990099,32.00990099009901,254.95049504950492,415,664,0.625,83,0,415,415,0.625
2,12,Manufacturer 5,132,7,Retailer 5,95,95,0,37,380,665,0.5714285714285714,91,4,84.75247524752476,6.247524752475243,339.009900990099,364,637,0.5714285714285714,91,0,364,364,0.5714285714285714
2,13,Manufacturer 5,62,7,Retailer 5,90,62,28,0,360,630,0.5714285714285714,91,-1,81.88118811881188,9.118811881188122,327.5247524752475,364,637,0.5714285714285714,62,29,248,364,0.5714285714285714
2,14,Manufacturer 5,136,7,Retailer 5,85,85,0,51,340,595,0.5714285714285714,91,-6,78.76237623762377,12.23762376237623,315.049504950495,364,637,0.5714285714285714,91,0,364,364,0.5714285714285714
2,15,Manufacturer 5,146,7,Retailer 5,80,80,0,66,320,560,0.5714285714285714,91,-11,75.39603960396039,15.60396039603961,301.58415841584156,364,637,0.5714285714285714,91,0,364,364,0.5714285714285714
2,16,Manufacturer 5,95,7,Retailer 5,70,70,0,25,280,490,0.5714285714285714,91,-21,67.92079207920793,23.079207920792072,271.6831683168317,364,637,0.5714285714285714,91,0,364,364,0.5714285714285714
2,17,Manufacturer 5,139,8,Retailer 5,0,0,0,139,0,0,0.0,83,-83,0.0,83.0,0.0,415,664,0.625,83,0,415,415,0.625
2,18,Manufacturer 5,102,7,Retailer 5,51,51,0,51,204,357,0.5714285714285714,91,-40,50.99009900990099,40.00990099009901,203.96039603960395,364,637,0.5714285714285714,91,0,364,364,0.5714285714285714
2,19,Manufacturer 5,83,7,Retailer 5,51,51,0,32,204,357,0.5714285714285714,91,-40,50.99009900990099,40.00990099009901,203.96039603960395,364,637,0.5714285714285714,83,8,332,364,0.5714285714285714
2,20,Manufacturer 5,142,7,Retailer 5,51,51,0,91,204,357,0.5714285714285714,91,-40,50.99009900990099,40.00990099009901,203.96039603960395,364,637,0.5714285714285714,91,0,364,364,0.5714285714285714
2,21,Manufacturer 5,80,7,Retailer 5,51,51,0,29,204,357,0.5714285714285714,91,-40,50.99009900990099,40.00990099009901,203.96039603960395,364,637,0.5714285714285714,80,11,320,364,0.5714285714285714
2,22,Manufacturer 5,101,6,Retailer 5,135,101,34,0,405,810,0.5,100,35,98.81188118811882,1.188118811881182,296.43564356435644,300,600,0.5,100,0,300,300,0.5
2,23,Manufacturer 5,113,6,Retailer 5,135,113,22,0,405,810,0.5,100,35,98.81188118811882,1.188118811881182,296.43564356435644,300,600,0.5,100,0,300,300,0.5
2,24,Manufacturer 5,104,6,Retailer 5,135,104,31,0,405,810,0.5,100,35,98.81188118811882,1.188118811881182,296.43564356435644,300,600,0.5,100,0,300,300,0.5
2,25,Manufacturer 5,51,6,Retailer 5,135,51,84,0,405,810,0.5,100,35,98.81188118811882,1.188118811881182,296.43564356435644,300,600,0.5,51,49,153,300,0.5
2,26,Manufacturer 5,76,6,Retailer 5,135,76,59,0,405,810,0.5,100,35,98.81188118811882,1.188118811881182,296.43564356435644,300,600,0.5,76,24,228,300,0.5
2,27,Manufacturer 5,73,6,Retailer 5,135,73,62,0,405,810,0.5,100,35,98.81188118811882,1.188118811881182,296.43564356435644,300,600,0.5,73,27,219,300,0.5
2,28,Manufacturer 5,83,3,Retailer 5,150,83,67,0,0,450,0.0,125,25,100.0,25.0,0.0,0,375,0.0,83,42,0,0,0.0
2,29,Manufacturer 5,147,6,Retailer 5,135,135,0,12,405,810,0.5,100,35,98.81188118811882,1.188118811881182,296.43564356435644,300,600,0.5,100,0,300,300,0.5
2,30,Manufacturer 5,115,6,Retailer 5,135,115,20,0,405,810,0.5,100,35,98.81188118811882,1.188118811881182,296.43564356435644,300,600,0.5,100,0,300,300,0.5
2,31,Manufacturer 5,139,6,Retailer 5,135,135,0,4,405,810,0.5,100,35,98.81188118811882,1.188118811881182,296.43564356435644,300,600,0.5,100,0,300,300,0.5
2,32,Manufacturer 5,59,6,Retailer 5,135,59,76,0,405,810,0.5,100,35,98.81188118811882,1.188118811881182,296.43564356435644,300,600,0.5,59,41,177,300,0.5
2,33,Manufacturer 5,122,3,Retailer 5,150,122,28,0,0,450,0.0,125,25,100.0,25.0,0.0,0,375,0.0,122,3,0,0,0.0
2,34,Manufacturer 5,92,6,Retailer 5,135,92,43,0,405,810,0.5,100,35,98.81188118811882,1.188118811881182,296.43564356435644,300,600,0.5,92,8,276,300,0.5
2,35,Manufacturer 5,93,6,Retailer 5,135,93,42,0,405,810,0.5,100,35,98.81188118811882,1.188118811881182,296.43564356435644,300,600,0.5,93,7,279,300,0.5
2,36,Manufacturer 5,136,6,Retailer 5,135,135,0,1,405,810,0.5,100,35,98.81188118811882,1.188118811881182,296.43564356435644,300,600,0.5,100,0,300,300,0.5
2,37,Manufacturer 5,116,6,Retailer 5,135,116,19,0,405,810,0.5,100,35,98.81188118811882,1.188118811881182,296.43564356435644,300,600,0.5,100,0,300,300,0.5
2,38,Manufacturer 5,105,6,Retailer 5,135,105,30,0,405,810,0.5,100,35,98.81188118811882,1.188118811881182,296.43564356435644,300,600,0.5,100,0,300,300,0.5
2,39,Manufacturer 5,80,6,Retailer 5,135,80,55,0,405,810,0.5,100,35,98.81188118811882,1.188118811881182,296.43564356435644,300,600,0.5,80,20,240,300,0.5
2,40,Manufacturer 5,75,6,Retailer 5,135,75,60,0,405,810,0.5,100,35,98.81188118811882,1.188118811881182,296.43564356435644,300,600,0.5,75,25,225,300,0.5
2,1,Manufacturer 6,122,8,Retailer 6,100,100,0,22,500,800,0.625,83,17,87.37623762376238,-4.376237623762378,436.8811881188119,415,664,0.625,83,0,415,415,0.625
2,2,Manufacturer 6,144,7,Retailer 6,125,125,0,19,500,875,0.5714285714285714,91,34,96.78217821782178,-5.78217821782178,387.1287128712871,364,637,0.5714285714285714,91,0,364,364,0.5714285714285714
2,3,Manufacturer 6,57,9,Retailer 6,88,57,31,0,528,792,0.6666666666666666,75,13,80.66336633663366,-5.663366336633658,483.98019801980195,450,675,0.6666666666666666,57,18,342,450,0.6666666666666666
2,4,Manufacturer 6,149,8,Retailer 6,100,100,0,49,500,800,0.625,83,17,87.37623762376238,-4.376237623762378,436.8811881188119,415,664,0.625,83,0,415,415,0.625
2,5,Manufacturer 6,135,7,Retailer 6,150,135,15,0,600,1050,0.5714285714285714,91,59,100.0,-9.0,400.0,364,637,0.5714285714285714,91,0,364,364,0.5714285714285714
2,6,Manufacturer 6,94,9,Retailer 6,94,94,0,0,564,846,0.6666666666666666,75,19,84.1980198019802,-9.198019801980195,505.18811881188117,450,675,0.6666666666666666,75,0,450,450,0.6666666666666666
2,7,Manufacturer 6,143,8,Retailer 6,114,114,0,29,570,912,0.625,83,31,93.4059405940594,-10.405940594059402,467.029702970297,415,664,0.625,83,0,415,415,0.625
2,8,Manufacturer 6,66,9,Retailer 6,85,66,19,0,510,765,0.6666666666666666,75,10,78.76237623762377,-3.7623762376237693,472.57425742574264,450,675,0.6666666666666666,66,9,396,450,0.6666666666666666
2,9,Manufacturer 6,123,6,Retailer 6,140,123,17,0,420,840,0.5,100,40,99.45544554455445,0.5445544554455495,298.36633663366337,300,600,0.5,100,0,300,300,0.5
2,10,Manufacturer 6,73,7,Retailer 6,120,73,47,0,480,840,0.5714285714285714,91,29,95.39603960396039,-4.396039603960389,381.58415841584156,364,637,0.5714285714285714,73,18,292,364,0.5714285714285714
2,11,Manufacturer 6,142,8,Retailer 6,90,90,0,52,450,720,0.625,83,7,81.88118811881188,1.1188118811881225,409.4059405940594,415,664,0.625,83,0,415,415,0.625
2,12,Manufacturer 6,132,7,Retailer 6,100,100,0,32,400,700,0.5714285714285714,91,9,87.37623762376238,3.6237623762376217,349.50495049504957,364,637,0.5714285714285714,91,0,364,364,0.5714285714285714
2,13,Manufacturer 6,62,9,Retailer 6,110,62,48,0,660,990,0.6666666666666666,75,35,91.88118811881188,-16.881188118811878,551.2871287128713,450,675,0.6666666666666666,62,13,372,450,0.6666666666666666
2,14,Manufacturer 6,136,9,Retailer 6,88,88,0,48,528,792,0.6666666666666666,75,13,80.66336633663366,-5.663366336633658,483.98019801980195,450,675,0.6666666666666666,75,0,450,450,0.6666666666666666
2,15,Manufacturer 6,146,9,Retailer 6,95,95,0,51,570,855,0.6666666666666666,75,20,84.75247524752476,-9.752475247524757,508.5148514851486,450,675,0.6666666666666666,75,0,450,450,0.6666666666666666
2,16,Manufacturer 6,95,8,Retailer 6,103,95,8,0,515,824,0.625,83,20,88.83168316831683,-5.831683168316829,444.15841584158414,415,664,0.625,83,0,415,415,0.625
2,17,Manufacturer 6,139,8,Retailer 6,66,66,0,73,330,528,0.625,83,-17,64.65346534653466,18.34653465346534,323.26732673267327,415,664,0.625,83,0,415,415,0.625
2,18,Manufacturer 6,102,9,Retailer 6,135,102,33,0,810,1215,0.6666666666666666,75,60,98.81188118811882,-23.811881188118818,592.871287128713,450,675,0.6666666666666666,75,0,450,450,0.6666666666666666
2,19,Manufacturer 6,83,7,Retailer 6,104,83,21,0,416,728,0.5714285714285714,91,13,89.29702970297029,1.702970297029708,357.1881188118811,364,637,0.5714285714285714,83,8,332,364,0.5714285714285714
2,20,Manufacturer 6,142,8,Retailer 6,79,79,0,63,395,632,0.625,83,-4,74.6930693069307,8.306930693069305,373.46534653465346,415,664,0.625,83,0,415,415,0.625
2,21,Manufacturer 6,80,9,Retailer 6,85,80,5,0,510,765,0.6666666666666666,75,10,78.76237623762377,-3.7623762376237693,472.57425742574264,450,675,0.6666666666666666,75,0,450,450,0.6666666666666666
2,22,Manufacturer 6,101,9,Retailer 6,75,75,0,26,450,675,0.6666666666666666,75,0,71.78217821782178,3.21782178217822,430.6930693069306,450,675,0.6666666666666666,75,0,450,450,0.6666666666666666
2,23,Manufacturer 6,113,8,Retailer 6,0,0,0,113,0,0,0.0,83,-83,0.0,83.0,0.0,415,664,0.625,83,0,415,415,0.625
2,24,Manufacturer 6,104,10,Retailer 6,75,75,0,29,525,750,0.7,66,9,71.78217821782178,-5.78217821782178,502.4752475247524,462,660,0.7,66,0,462,462,0.7
2,25,Manufacturer 6,51,8,Retailer 6,90,51,39,0,450,720,0.625,83,7,81.88118811881188,1.1188118811881225,409.4059405940594,415,664,0.625,51,32,255,415,0.625
2,26,Manufacturer 6,76,7,Retailer 6,135,76,59,0,540,945,0.5714285714285714,91,44,98.81188118811882,-7.811881188118818,395.2475247524753,364,637,0.5714285714285714,76,15,304,364,0.5714285714285714
2,27,Manufacturer 6,73,6,Retailer 6,140,73,67,0,420,840,0.5,100,40,99.45544554455445,0.5445544554455495,298.36633663366337,300,600,0.5,73,27,219,300,0.5
2,28,Manufacturer 6,83,7,Retailer 6,130,83,47,0,520,910,0.5714285714285714,91,39,97.92079207920793,-6.920792079207928,391.6831683168317,364,637,0.5714285714285714,83,8,332,364,0.5714285714285714
2,29,Manufacturer 6,147,7,Retailer 6,100,100,0,47,400,700,0.5714285714285714,91,9,87.37623762376238,3.6237623762376217,349.50495049504957,364,637,0.5714285714285714,91,0,364,364,0.5714285714285714
2,30,Manufacturer 6,115,9,Retailer 6,57,57,0,58,342,513,0.6666666666666666,75,-18,56.722772277227726,18.277227722772274,340.33663366336634,450,675,0.6666666666666666,75,0,450,450,0.6666666666666666
2,31,Manufacturer 6,139,10,Retailer 6,0,0,0,139,0,0,0.0,66,-66,0.0,66.0,0.0,462,660,0.7,66,0,462,462,0.7
2,32,Manufacturer 6,59,11,Retailer 6,51,51,0,8,408,561,0.7272727272727273,58,-7,50.99009900990099,7.009900990099013,407.92079207920784,464,638,0.7272727272727273,58,0,464,464,0.7272727272727273
2,33,Manufacturer 6,122,8,Retailer 6,78,78,0,44,390,624,0.625,83,-5,73.98019801980197,9.019801980198025,369.90099009900985,415,664,0.625,83,0,415,415,0.625
2,34,Manufacturer 6,92,7,Retailer 6,0,0,0,92,0,0,0.0,91,-91,0.0,91.0,0.0,364,637,0.5714285714285714,91,0,364,364,0.5714285714285714
2,35,Manufacturer 6,93,7,Retailer 6,100,93,7,0,400,700,0.5714285714285714,91,9,87.37623762376238,3.6237623762376217,349.50495049504957,364,637,0.5714285714285714,91,0,364,364,0.5714285714285714
2,36,Manufacturer 6,136,7,Retailer 6,101,101,0,35,404,707,0.5714285714285714,91,10,87.87128712871286,3.128712871287135,351.48514851485146,364,637,0.5714285714285714,91,0,364,364,0.5714285714285714
2,37,Manufacturer 6,116,7,Retailer 6,99,99,0,17,396,693,0.5714285714285714,91,8,86.87128712871286,4.128712871287135,347.48514851485146,364,637,0.5714285714285714,91,0,364,364,0.5714285714285714
2,38,Manufacturer 6,105,9,Retailer 6,65,65,0,40,390,585,0.6666666666666666,75,-10,63.81188118811881,11.18811881188119,382.8712871287128,450,675,0.6666666666666666,75,0,450,450,0.6666666666666666
2,39,Manufacturer 6,80,7,Retailer 6,115,80,35,0,460,805,0.5714285714285714,91,24,93.76237623762377,-2.7623762376237693,375.049504950495,364,637,0.5714285714285714,80,11,320,364,0.5714285714285714
2,40,Manufacturer 6,75,7,Retailer 6,100,75,25,0,400,700,0.5714285714285714,91,9,87.37623762376238,3.6237623762376217,349.50495049504957,364,637,0.5714285714285714,75,16,300,364,0.5714285714285714
2,1,Manufacturer 7,122,7,Retailer 7,100,100,0,22,400,700,0.5714285714285714,91,9,87.37623762376238,3.6237623762376217,349.50495049504957,364,637,0.5714285714285714,91,0,364,364,0.5714285714285714
2,2,Manufacturer 7,144,7,Retailer 7,90,90,0,54,360,630,0.5714285714285714,91,-1,81.88118811881188,9.118811881188122,327.5247524752475,364,637,0.5714285714285714,91,0,364,364,0.5714285714285714
2,3,Manufacturer 7,57,7,Retailer 7,100,57,43,0,400,700,0.5714285714285714,91,9,87.37623762376238,3.6237623762376217,349.50495049504957,364,637,0.5714285714285714,57,34,228,364,0.5714285714285714
2,4,Manufacturer 7,149,7,Retailer 7,70,70,0,79,280,490,0.5714285714285714,91,-21,67.92079207920793,23.079207920792072,271.6831683168317,364,637,0.5714285714285714,91,0,364,364,0.5714285714285714
2,5,Manufacturer 7,135,6,Retailer 7,100,100,0,35,300,600,0.5,100,0,87.37623762376238,12.623762376237622,262.1287128712871,300,600,0.5,100,0,300,300,0.5
2,6,Manufacturer 7,94,7,Retailer 7,70,70,0,24,280,490,0.5714285714285714,91,-21,67.92079207920793,23.079207920792072,271.6831683168317,364,637,0.5714285714285714,91,0,364,364,0.5714285714285714
2,7,Manufacturer 7,143,8,Retailer 7,51,51,0,92,255,408,0.625,83,-32,50.99009900990099,32.00990099009901,254.95049504950492,415,664,0.625,83,0,415,415,0.625
2,8,Manufacturer 7,66,7,Retailer 7,70,66,4,0,280,490,0.5714285714285714,91,-21,67.92079207920793,23.079207920792072,271.6831683168317,364,637,0.5714285714285714,66,25,264,364,0.5714285714285714
2,9,Manufacturer 7,123,7,Retailer 7,80,80,0,43,320,560,0.5714285714285714,91,-11,75.39603960396039,15.60396039603961,301.58415841584156,364,637,0.5714285714285714,91,0,364,364,0.5714285714285714
2,10,Manufacturer 7,73,5,Retailer 7,140,73,67,0,280,700,0.4,108,32,99.45544554455445,8.54455445544555,198.91089108910887,216,540,0.4,73,35,146,216,0.4
2,11,Manufacturer 7,142,6,Retailer 7,100,100,0,42,300,600,0.5,100,0,87.37623762376238,12.623762376237622,262.1287128712871,300,600,0.5,100,0,300,300,0.5
2,12,Manufacturer 7,132,6,Retailer 7,120,120,0,12,360,720,0.5,100,20,95.39603960396039,4.603960396039611,286.18811881188117,300,600,0.5,100,0,300,300,0.5
2,13,Manufacturer 7,62,7,Retailer 7,70,62,8,0,280,490,0.5714285714285714,91,-21,67.92079207920793,23.079207920792072,271.6831683168317,364,637,0.5714285714285714,62,29,248,364,0.5714285714285714
2,14,Manufacturer 7,136,7,Retailer 7,80,80,0,56,320,560,0.5714285714285714,91,-11,75.39603960396039,15.60396039603961,301.58415841584156,364,637,0.5714285714285714,91,0,364,364,0.5714285714285714
2,15,Manufacturer 7,146,7,Retailer 7,80,80,0,66,320,560,0.5714285714285714,91,-11,75.39603960396039,15.60396039603961,301.58415841584156,364,637,0.5714285714285714,91,0,364,364,0.5714285714285714
2,16,Manufacturer 7,95,8,Retailer 7,51,51,0,44,255,408,0.625,83,-32,50.99009900990099,32.00990099009901,254.95049504950492,415,664,0.625,83,0,415,415,0.625
2,17,Manufacturer 7,139,7,Retailer 7,80,80,0,59,320,560,0.5714285714285714,91,-11,75.39603960396039,15.60396039603961,301.58415841584156,364,637,0.5714285714285714,91,0,364,364,0.5714285714285714
2,18,Manufacturer 7,102,6,Retailer 7,120,102,18,0,360,720,0.5,100,20,95.39603960396039,4.603960396039611,286.18811881188117,300,600,0.5,100,0,300,300,0.5
2,19,Manufacturer 7,83,6,Retailer 7,100,83,17,0,300,600,0.5,100,0,87.37623762376238,12.623762376237622,262.1287128712871,300,600,0.5,83,17,249,300,0.5
2,20,Manufacturer 7,142,7,Retailer 7,80,80,0,62,320,560,0.5714285714285714,91,-11,75.39603960396039,15.60396039603961,301.58415841584156,364,637,0.5714285714285714,91,0,364,364,0.5714285714285714
2,21,Manufacturer 7,80,6,Retailer 7,110,80,30,0,330,660,0.5,100,10,91.88118811881188,8.118811881188122,275.6435643564356,300,600,0.5,80,20,240,300,0.5
2,22,Manufacturer 7,101,6,Retailer 7,120,101,19,0,360,720,0.5,100,20,95.39603960396039,4.603960396039611,286.18811881188117,300,600,0.5,100,0,300,300,0.5
2,23,Manufacturer 7,113,6,Retailer 7,120,113,7,0,360,720,0.5,100,20,95.39603960396039,4.603960396039611,286.18811881188117,300,600,0.5,100,0,300,300,0.5
2,24,Manufacturer 7,104,6,Retailer 7,100,100,0,4,300,600,0.5,100,0,87.37623762376238,12.623762376237622,262.1287128712871,300,600,0.5,100,0,300,300,0.5
2,25,Manufacturer 7,51,7,Retailer 7,70,51,19,0,280,490,0.5714285714285714,91,-21,67.92079207920793,23.079207920792072,271.6831683168317,364,637,0.5714285714285714,51,40,204,364,0.5714285714285714
2,26,Manufacturer 7,76,7,Retailer 7,70,70,0,6,280,490,0.5714285714285714,91,-21,67.92079207920793,23.079207920792072,271.6831683168317,364,637,0.5714285714285714,76,15,304,364,0.5714285714285714
2,27,Manufacturer 7,73,6,Retailer 7,120,73,47,0,360,720,0.5,100,20,95.39603960396039,4.603960396039611,286.18811881188117,300,600,0.5,73,27,219,300,0.5
2,28,Manufacturer 7,83,6,Retailer 7,100,83,17,0,300,600,0.5,100,0,87.37623762376238,12.623762376237622,262.1287128712871,300,600,0.5,83,17,249,300,0.5
2,29,Manufacturer 7,147,6,Retailer 7,120,120,0,27,360,720,0.5,100,20,95.39603960396039,4.603960396039611,286.18811881188117,300,600,0.5,100,0,300,300,0.5
2,30,Manufacturer 7,115,6,Retailer 7,100,100,0,15,300,600,0.5,100,0,87.37623762376238,12.623762376237622,262.1287128712871,300,600,0.5,100,0,300,300,0.5
2,31,Manufacturer 7,139,6,Retailer 7,100,100,0,39,300,600,0.5,100,0,87.37623762376238,12.623762376237622,262.1287128712871,300,600,0.5,100,0,300,300,0.5
2,32,Manufacturer 7,59,7,Retailer 7,60,59,1,0,240,420,0.5714285714285714,91,-31,59.45544554455446,31.544554455445542,237.82178217821786,364,637,0.5714285714285714,59,32,236,364,0.5714285714285714
2,33,Manufacturer 7,122,6,Retailer 7,120,120,0,2,360,720,0.5,100,20,95.39603960396039,4.603960396039611,286.18811881188117,300,600,0.5,100,0,300,300,0.5
2,34,Manufacturer 7,92,6,Retailer 7,100,92,8,0,300,600,0.5,100,0,87.37623762376238,12.623762376237622,262.1287128712871,300,600,0.5,92,8,276,300,0.5
2,35,Manufacturer 7,93,6,Retailer 7,120,93,27,0,360,720,0.5,100,20,95.39603960396039,4.603960396039611,286.18811881188117,300,600,0.5,93,7,279,300,0.5
2,36,Manufacturer 7,136,6,Retailer 7,120,120,0,16,360,720,0.5,100,20,95.39603960396039,4.603960396039611,286.18811881188117,300,600,0.5,100,0,300,300,0.5
2,37,Manufacturer 7,116,6,Retailer 7,90,90,0,26,270,540,0.5,100,-10,81.88118811881188,18.118811881188122,245.64356435643563,300,600,0.5,100,0,300,300,0.5
2,38,Manufacturer 7,105,7,Retailer 7,70,70,0,35,280,490,0.5714285714285714,91,-21,67.92079207920793,23.079207920792072,271.6831683168317,364,637,0.5714285714285714,91,0,364,364,0.5714285714285714
2,39,Manufacturer 7,80,7,Retailer 7,70,70,0,10,280,490,0.5714285714285714,91,-21,67.92079207920793,23.079207920792072,271.6831683168317,364,637,0.5714285714285714,80,11,320,364,0.5714285714285714
2,40,Manufacturer 7,75,6,Retailer 7,120,75,45,0,360,720,0.5,100,20,95.39603960396039,4.603960396039611,286.18811881188117,300,600,0.5,75,25,225,300,0.5
2,1,Manufacturer 8,122,7,Retailer 8,110,110,0,12,440,770,0.5714285714285714,91,19,91.88118811881188,-0.8811881188118775,367.5247524752475,364,637,0.5714285714285714,91,0,364,364,0.5714285714285714
2,2,Manufacturer 8,144,7,Retailer 8,122,122,0,22,488,854,0.5714285714285714,91,31,95.98019801980197,-4.980198019801975,383.9207920792079,364,637,0.5714285714285714,91,0,364,364,0.5714285714285714
2,3,Manufacturer 8,57,8,Retailer 8,100,57,43,0,500,800,0.625,83,17,87.37623762376238,-4.376237623762378,436.8811881188119,415,664,0.625,57,26,285,415,0.625
2,4,Manufacturer 8,149,8,Retailer 8,60,60,0,89,300,480,0.625,83,-23,59.45544554455446,23.544554455445542,297.2772277227723,415,664,0.625,83,0,415,415,0.625
2,5,Manufacturer 8,135,7,Retailer 8,125,125,0,10,500,875,0.5714285714285714,91,34,96.78217821782178,-5.78217821782178,387.1287128712871,364,637,0.5714285714285714,91,0,364,364,0.5714285714285714
2,6,Manufacturer 8,94,7,Retailer 8,100,94,6,0,400,700,0.5714285714285714,91,9,87.37623762376238,3.6237623762376217,349.50495049504957,364,637,0.5714285714285714,91,0,364,364,0.5714285714285714
2,7,Manufacturer 8,143,8,Retailer 8,51,51,0,92,255,408,0.625,83,-32,50.99009900990099,32.00990099009901,254.95049504950492,415,664,0.625,83,0,415,415,0.625
2,8,Manufacturer 8,66,7,Retailer 8,99,66,33,0,396,693,0.5714285714285714,91,8,86.87128712871286,4.128712871287135,347.48514851485146,364,637,0.5714285714285714,66,25,264,364,0.5714285714285714
2,9,Manufacturer 8,123,7,Retailer 8,88,88,0,35,352,616,0.5714285714285714,91,-3,80.66336633663366,10.336633663366342,322.65346534653463,364,637,0.5714285714285714,91,0,364,364,0.5714285714285714
2,10,Manufacturer 8,73,9,Retailer 8,51,51,0,22,306,459,0.6666666666666666,75,-24,50.99009900990099,24.009900990099013,305.9405940594059,450,675,0.6666666666666666,73,2,438,450,0.6666666666666666
2,11,Manufacturer 8,142,7,Retailer 8,77,77,0,65,308,539,0.5714285714285714,91,-14,73.25742574257426,17.742574257425744,293.029702970297,364,637,0.5714285714285714,91,0,364,364,0.5714285714285714
2,12,Manufacturer 8,132,7,Retailer 8,66,66,0,66,264,462,0.5714285714285714,91,-25,64.65346534653466,26.34653465346534,258.61386138613864,364,637,0.5714285714285714,91,0,364,364,0.5714285714285714
2,13,Manufacturer 8,62,7,Retailer 8,60,60,0,2,240,420,0.5714285714285714,91,-31,59.45544554455446,31.544554455445542,237.82178217821786,364,637,0.5714285714285714,62,29,248,364,0.5714285714285714
2,14,Manufacturer 8,136,7,Retailer 8,100,100,0,36,400,700,0.5714285714285714,91,9,87.37623762376238,3.6237623762376217,349.50495049504957,364,637,0.5714285714285714,91,0,364,364,0.5714285714285714
2,15,Manufacturer 8,146,7,Retailer 8,60,60,0,86,240,420,0.5714285714285714,91,-31,59.45544554455446,31.544554455445542,237.82178217821786,364,637,0.5714285714285714,91,0,364,364,0.5714285714285714
2,16,Manufacturer 8,95,7,Retailer 8,66,66,0,29,264,462,0.5714285714285714,91,-25,64.65346534653466,26.34653465346534,258.61386138613864,364,637,0.5714285714285714,91,0,364,364,0.5714285714285714
2,17,Manufacturer 8,139,6,Retailer 8,120,120,0,19,360,720,0.5,100,20,95.39603960396039,4.603960396039611,286.18811881188117,300,600,0.5,100,0,300,300,0.5
2,18,Manufacturer 8,102,6,Retailer 8,140,102,38,0,420,840,0.5,100,40,99.45544554455445,0.5445544554455495,298.36633663366337,300,600,0.5,100,0,300,300,0.5
2,19,Manufacturer 8,83,6,Retailer 8,130,83,47,0,390,780,0.5,100,30,97.92079207920793,2.079207920792072,293.7623762376238,300,600,0.5,83,17,249,300,0.5
2,20,Manufacturer 8,142,6,Retailer 8,130,130,0,12,390,780,0.5,100,30,97.92079207920793,2.079207920792072,293.7623762376238,300,600,0.5,100,0,300,300,0.5
2,21,Manufacturer 8,80,6,Retailer 8,120,80,40,0,360,720,0.5,100,20,95.39603960396039,4.603960396039611,286.18811881188117,300,600,0.5,80,20,240,300,0.5
2,22,Manufacturer 8,101,8,Retailer 8,70,70,0,31,350,560,0.625,83,-13,67.92079207920793,15.079207920792072,339.6039603960396,415,664,0.625,83,0,415,415,0.625
2,23,Manufacturer 8,113,7,Retailer 8,80,80,0,33,320,560,0.5714285714285714,91,-11,75.39603960396039,15.60396039603961,301.58415841584156,364,637,0.5714285714285714,91,0,364,364,0.5714285714285714
2,24,Manufacturer 8,104,7,Retailer 8,80,80,0,24,320,560,0.5714285714285714,91,-11,75.39603960396039,15.60396039603961,301.58415841584156,364,637,0.5714285714285714,91,0,364,364,0.5714285714285714
2,25,Manufacturer 8,51,6,Retailer 8,90,51,39,0,270,540,0.5,100,-10,81.88118811881188,18.118811881188122,245.64356435643563,300,600,0.5,51,49,153,300,0.5
2,26,Manufacturer 8,76,9,Retailer 8,60,60,0,16,360,540,0.6666666666666666,75,-15,59.45544554455446,15.544554455445542,356.7326732673268,450,675,0.6666666666666666,75,0,450,450,0.6666666666666666
2,27,Manufacturer 8,73,7,Retailer 8,110,73,37,0,440,770,0.5714285714285714,91,19,91.88118811881188,-0.8811881188118775,367.5247524752475,364,637,0.5714285714285714,73,18,292,364,0.5714285714285714
2,28,Manufacturer 8,83,7,Retailer 8,110,83,27,0,440,770,0.5714285714285714,91,19,91.88118811881188,-0.8811881188118775,367.5247524752475,364,637,0.5714285714285714,83,8,332,364,0.5714285714285714
2,29,Manufacturer 8,147,7,Retailer 8,110,110,0,37,440,770,0.5714285714285714,91,19,91.88118811881188,-0.8811881188118775,367.5247524752475,364,637,0.5714285714285714,91,0,364,364,0.5714285714285714
2,30,Manufacturer 8,115,7,Retailer 8,115,115,0,0,460,805,0.5714285714285714,91,24,93.76237623762377,-2.7623762376237693,375.049504950495,364,637,0.5714285714285714,91,0,364,364,0.5714285714285714
2,31,Manufacturer 8,139,7,Retailer 8,90,90,0,49,360,630,0.5714285714285714,91,-1,81.88118811881188,9.118811881188122,327.5247524752475,364,637,0.5714285714285714,91,0,364,364,0.5714285714285714
2,32,Manufacturer 8,59,11,Retailer 8,51,51,0,8,408,561,0.7272727272727273,58,-7,50.99009900990099,7.009900990099013,407.92079207920784,464,638,0.7272727272727273,58,0,464,464,0.7272727272727273
2,33,Manufacturer 8,122,11,Retailer 8,60,60,0,62,480,660,0.7272727272727273,58,2,59.45544554455446,-1.4554455445544576,475.64356435643566,464,638,0.7272727272727273,58,0,464,464,0.7272727272727273
2,34,Manufacturer 8,92,11,Retailer 8,0,0,0,92,0,0,0.0,58,-58,0.0,58.0,0.0,464,638,0.7272727272727273,58,0,464,464,0.7272727272727273
2,35,Manufacturer 8,93,7,Retailer 8,120,93,27,0,480,840,0.5714285714285714,91,29,95.39603960396039,-4.396039603960389,381.58415841584156,364,637,0.5714285714285714,91,0,364,364,0.5714285714285714
2,36,Manufacturer 8,136,7,Retailer 8,110,110,0,26,440,770,0.5714285714285714,91,19,91.88118811881188,-0.8811881188118775,367.5247524752475,364,637,0.5714285714285714,91,0,364,364,0.5714285714285714
2,37,Manufacturer 8,116,7,Retailer 8,120,116,4,0,480,840,0.5714285714285714,91,29,95.39603960396039,-4.396039603960389,381.58415841584156,364,637,0.5714285714285714,91,0,364,364,0.5714285714285714
2,38,Manufacturer 8,105,7,Retailer 8,90,90,0,15,360,630,0.5714285714285714,91,-1,81.88118811881188,9.118811881188122,327.5247524752475,364,637,0.5714285714285714,91,0,364,364,0.5714285714285714
2,39,Manufacturer 8,80,11,Retailer 8,60,60,0,20,480,660,0.7272727272727273,58,2,59.45544554455446,-1.4554455445544576,475.64356435643566,464,638,0.7272727272727273,58,0,464,464,0.7272727272727273
2,40,Manufacturer 8,75,11,Retailer 8,65,65,0,10,520,715,0.7272727272727273,58,7,63.81188118811881,-5.811881188118811,510.4950495049505,464,638,0.7272727272727273,58,0,464,464,0.7272727272727273
3,1,Manufacturer 9,122,8,Retailer 9,0,0,0,122,0,0,0.0,83,-83,0.0,83.0,0.0,415,664,0.625,83,0,415,415,0.625
3,2,Manufacturer 9,144,7,Retailer 9,118,118,0,26,472,826,0.5714285714285714,91,27,94.77227722772277,-3.7722772277227676,379.0891089108911,364,637,0.5714285714285714,91,0,364,364,0.5714285714285714
3,3,Manufacturer 9,57,8,Retailer 9,110,57,53,0,550,880,0.625,83,27,91.88118811881188,-8.881188118811878,459.4059405940594,415,664,0.625,57,26,285,415,0.625
3,4,Manufacturer 9,149,6,Retailer 9,108,108,0,41,324,648,0.5,100,8,91.05940594059406,8.940594059405939,273.1782178217822,300,600,0.5,100,0,300,300,0.5
3,5,Manufacturer 9,135,8,Retailer 9,100,100,0,35,500,800,0.625,83,17,87.37623762376238,-4.376237623762378,436.8811881188119,415,664,0.625,83,0,415,415,0.625
3,6,Manufacturer 9,94,8,Retailer 9,94,94,0,0,470,752,0.625,83,11,84.1980198019802,-1.1980198019801946,420.990099009901,415,664,0.625,83,0,415,415,0.625
3,7,Manufacturer 9,143,8,Retailer 9,98,98,0,45,490,784,0.625,83,15,86.35643564356435,-3.356435643564353,431.78217821782175,415,664,0.625,83,0,415,415,0.625
3,8,Manufacturer 9,66,9,Retailer 9,95,66,29,0,570,855,0.6666666666666666,75,20,84.75247524752476,-9.752475247524757,508.5148514851486,450,675,0.6666666666666666,66,9,396,450,0.6666666666666666
3,9,Manufacturer 9,123,7,Retailer 9,130,123,7,0,520,910,0.5714285714285714,91,39,97.92079207920793,-6.920792079207928,391.6831683168317,364,637,0.5714285714285714,91,0,364,364,0.5714285714285714
3,10,Manufacturer 9,73,7,Retailer 9,100,73,27,0,400,700,0.5714285714285714,91,9,87.37623762376238,3.6237623762376217,349.50495049504957,364,637,0.5714285714285714,73,18,292,364,0.5714285714285714
3,11,Manufacturer 9,142,9,Retailer 9,100,100,0,42,600,900,0.6666666666666666,75,25,87.37623762376238,-12.376237623762378,524.2574257425742,450,675,0.6666666666666666,75,0,450,450,0.6666666666666666
3,12,Manufacturer 9,132,9,Retailer 9,93,93,0,39,558,837,0.6666666666666666,75,18,83.63366336633663,-8.633663366336634,501.80198019801975,450,675,0.6666666666666666,75,0,450,450,0.6666666666666666
3,13,Manufacturer 9,62,8,Retailer 9,110,62,48,0,550,880,0.625,83,27,91.88118811881188,-8.881188118811878,459.4059405940594,415,664,0.625,62,21,310,415,0.625
3,14,Manufacturer 9,136,7,Retailer 9,110,110,0,26,440,770,0.5714285714285714,91,19,91.88118811881188,-0.8811881188118775,367.5247524752475,364,637,0.5714285714285714,91,0,364,364,0.5714285714285714
3,15,Manufacturer 9,146,10,Retailer 9,70,70,0,76,490,700,0.7,66,4,67.92079207920793,-1.9207920792079278,475.4455445544554,462,660,0.7,66,0,462,462,0.7
3,16,Manufacturer 9,95,8,Retailer 9,130,95,35,0,650,1040,0.625,83,47,97.92079207920793,-14.920792079207928,489.6039603960396,415,664,0.625,83,0,415,415,0.625
3,17,Manufacturer 9,139,8,Retailer 9,100,100,0,39,500,800,0.625,83,17,87.37623762376238,-4.376237623762378,436.8811881188119,415,664,0.625,83,0,415,415,0.625
3,18,Manufacturer 9,102,9,Retailer 9,95,95,0,7,570,855,0.6666666666666666,75,20,84.75247524752476,-9.752475247524757,508.5148514851486,450,675,0.6666666666666666,75,0,450,450,0.6666666666666666
3,19,Manufacturer 9,83,9,Retailer 9,99,83,16,0,594,891,0.6666666666666666,75,24,86.87128712871286,-11.871287128712865,521.2277227722773,450,675,0.6666666666666666,75,0,450,450,0.6666666666666666
3,20,Manufacturer 9,142,8,Retailer 9,110,110,0,32,550,880,0.625,83,27,91.88118811881188,-8.881188118811878,459.4059405940594,415,664,0.625,83,0,415,415,0.625
3,21,Manufacturer 9,80,8,Retailer 9,107,80,27,0,535,856,0.625,83,24,90.63366336633663,-7.633663366336634,453.16831683168317,415,664,0.625,80,3,400,415,0.625
3,22,Manufacturer 9,101,9,Retailer 9,106,101,5,0,636,954,0.6666666666666666,75,31,90.1980198019802,-15.198019801980195,541.1881188118812,450,675,0.6666666666666666,75,0,450,450,0.6666666666666666
3,23,Manufacturer 9,113,10,Retailer 9,99,99,0,14,693,990,0.7,66,33,86.87128712871286,-20.871287128712865,608.09900990099,462,660,0.7,66,0,462,462,0.7
3,24,Manufacturer 9,104,10,Retailer 9,105,104,1,0,735,1050,0.7,66,39,89.75247524752476,-23.752475247524757,628.2673267326734,462,660,0.7,66,0,462,462,0.7
3,25,Manufacturer 9,51,10,Retailer 9,90,51,39,0,630,900,0.7,66,24,81.88118811881188,-15.881188118811878,573.1683168316832,462,660,0.7,51,15,357,462,0.7
3,26,Manufacturer 9,76,9,Retailer 9,106,76,30,0,636,954,0.6666666666666666,75,31,90.1980198019802,-15.198019801980195,541.1881188118812,450,675,0.6666666666666666,75,0,450,450,0.6666666666666666
3,27,Manufacturer 9,73,9,Retailer 9,88,73,15,0,528,792,0.6666666666666666,75,13,80.66336633663366,-5.663366336633658,483.98019801980195,450,675,0.6666666666666666,73,2,438,450,0.6666666666666666
3,28,Manufacturer 9,83,8,Retailer 9,112,83,29,0,560,896,0.625,83,29,92.66336633663366,-9.663366336633658,463.3168316831683,415,664,0.625,83,0,415,415,0.625
3,29,Manufacturer 9,147,8,Retailer 9,125,125,0,22,625,1000,0.625,83,42,96.78217821782178,-13.78217821782178,483.9108910891089,415,664,0.625,83,0,415,415,0.625
3,30,Manufacturer 9,115,10,Retailer 9,92,92,0,23,644,920,0.7,66,26,83.05940594059406,-17.05940594059406,581.4158415841584,462,660,0.7,66,0,462,462,0.7
3,31,Manufacturer 9,139,10,Retailer 9,96,96,0,43,672,960,0.7,66,30,85.29702970297029,-19.297029702970292,597.079207920792,462,660,0.7,66,0,462,462,0.7
3,32,Manufacturer 9,59,10,Retailer 9,100,59,41,0,700,1000,0.7,66,34,87.37623762376238,-21.37623762376238,611.6336633663367,462,660,0.7,59,7,413,462,0.7
3,33,Manufacturer 9,122,9,Retailer 9,103,103,0,19,618,927,0.6666666666666666,75,28,88.83168316831683,-13.831683168316829,532.9900990099011,450,675,0.6666666666666666,75,0,450,450,0.6666666666666666
3,34,Manufacturer 9,92,10,Retailer 9,85,85,0,7,595,850,0.7,66,19,78.76237623762377,-12.76237623762377,551.3366336633663,462,660,0.7,66,0,462,462,0.7
3,35,Manufacturer 9,93,9,Retailer 9,120,93,27,0,720,1080,0.6666666666666666,75,45,95.39603960396039,-20.39603960396039,572.3762376237623,450,675,0.6666666666666666,75,0,450,450,0.6666666666666666
3,36,Manufacturer 9,136,9,Retailer 9,110,110,0,26,660,990,0.6666666666666666,75,35,91.88118811881188,-16.881188118811878,551.2871287128713,450,675,0.6666666666666666,75,0,450,450,0.6666666666666666
3,37,Manufacturer 9,116,10,Retailer 9,106,106,0,10,742,1060,0.7,66,40,90.1980198019802,-24.198019801980195,631.3861386138614,462,660,0.7,66,0,462,462,0.7
3,38,Manufacturer 9,105,10,Retailer 9,76,76,0,29,532,760,0.7,66,10,72.52475247524752,-6.524752475247524,507.6732673267326,462,660,0.7,66,0,462,462,0.7
3,39,Manufacturer 9,80,9,Retailer 9,120,80,40,0,720,1080,0.6666666666666666,75,45,95.39603960396039,-20.39603960396039,572.3762376237623,450,675,0.6666666666666666,75,0,450,450,0.6666666666666666
3,40,Manufacturer 9,75,8,Retailer 9,105,75,30,0,525,840,0.625,83,22,89.75247524752476,-6.752475247524757,448.7623762376238,415,664,0.625,75,8,375,415,0.625
3,1,Manufacturer 10,122,9,Retailer 10,90,90,0,32,540,810,0.6666666666666666,75,15,81.88118811881188,-6.8811881188118775,491.2871287128713,450,675,0.6666666666666666,75,0,450,450,0.6666666666666666
3,2,Manufacturer 10,144,8,Retailer 10,98,98,0,46,490,784,0.625,83,15,86.35643564356435,-3.356435643564353,431.78217821782175,415,664,0.625,83,0,415,415,0.625
3,3,Manufacturer 10,57,9,Retailer 10,100,57,43,0,600,900,0.6666666666666666,75,25,87.37623762376238,-12.376237623762378,524.2574257425742,450,675,0.6666666666666666,57,18,342,450,0.6666666666666666
3,4,Manufacturer 10,149,8,Retailer 10,110,110,0,39,550,880,0.625,83,27,91.88118811881188,-8.881188118811878,459.4059405940594,415,664,0.625,83,0,415,415,0.625
3,5,Manufacturer 10,135,8,Retailer 10,115,115,0,20,575,920,0.625,83,32,93.76237623762377,-10.76237623762377,468.81188118811883,415,664,0.625,83,0,415,415,0.625
3,6,Manufacturer 10,94,9,Retailer 10,80,80,0,14,480,720,0.6666666666666666,75,5,75.39603960396039,-0.3960396039603893,452.37623762376234,450,675,0.6666666666666666,75,0,450,450,0.6666666666666666
3,7,Manufacturer 10,143,8,Retailer 10,132,132,0,11,660,1056,0.625,83,49,98.3069306930693,-15.306930693069305,491.53465346534654,415,664,0.625,83,0,415,415,0.625
3,8,Manufacturer 10,66,8,Retailer 10,120,66,54,0,600,960,0.625,83,37,95.39603960396039,-12.39603960396039,476.98019801980195,415,664,0.625,66,17,330,415,0.625
3,9,Manufacturer 10,123,9,Retailer 10,0,0,0,123,0,0,0.0,75,-75,0.0,75.0,0.0,450,675,0.6666666666666666,75,0,450,450,0.6666666666666666
3,10,Manufacturer 10,73,9,Retailer 10,100,73,27,0,600,900,0.6666666666666666,75,25,87.37623762376238,-12.376237623762378,524.2574257425742,450,675,0.6666666666666666,73,2,438,450,0.6666666666666666
3,11,Manufacturer 10,142,8,Retailer 10,115,115,0,27,575,920,0.625,83,32,93.76237623762377,-10.76237623762377,468.81188118811883,415,664,0.625,83,0,415,415,0.625
3,12,Manufacturer 10,132,9,Retailer 10,77,77,0,55,462,693,0.6666666666666666,75,2,73.25742574257426,1.7425742574257441,439.5445544554455,450,675,0.6666666666666666,75,0,450,450,0.6666666666666666
3,13,Manufacturer 10,62,8,Retailer 10,137,62,75,0,685,1096,0.625,83,54,99.0990099009901,-16.099009900990097,495.4950495049505,415,664,0.625,62,21,310,415,0.625
3,14,Manufacturer 10,136,8,Retailer 10,85,85,0,51,425,680,0.625,83,2,78.76237623762377,4.237623762376231,393.81188118811883,415,664,0.625,83,0,415,415,0.625
3,15,Manufacturer 10,146,9,Retailer 10,82,82,0,64,492,738,0.6666666666666666,75,7,76.77227722772277,-1.7722772277227676,460.6336633663366,450,675,0.6666666666666666,75,0,450,450,0.6666666666666666
3,16,Manufacturer 10,95,8,Retailer 10,65,65,0,30,325,520,0.625,83,-18,63.81188118811881,19.18811881188119,319.05940594059405,415,664,0.625,83,0,415,415,0.625
3,17,Manufacturer 10,139,8,Retailer 10,125,125,0,14,625,1000,0.625,83,42,96.78217821782178,-13.78217821782178,483.9108910891089,415,664,0.625,83,0,415,415,0.625
3,18,Manufacturer 10,102,9,Retailer 10,115,102,13,0,690,1035,0.6666666666666666,75,40,93.76237623762377,-18.76237623762377,562.5742574257426,450,675,0.6666666666666666,75,0,450,450,0.6666666666666666
3,19,Manufacturer 10,83,8,Retailer 10,75,75,0,8,375,600,0.625,83,-8,71.78217821782178,11.21782178217822,358.9108910891089,415,664,0.625,83,0,415,415,0.625
3,20,Manufacturer 10,142,8,Retailer 10,105,105,0,37,525,840,0.625,83,22,89.75247524752476,-6.752475247524757,448.7623762376238,415,664,0.625,83,0,415,415,0.625
3,21,Manufacturer 10,80,8,Retailer 10,132,80,52,0,660,1056,0.625,83,49,98.3069306930693,-15.306930693069305,491.53465346534654,415,664,0.625,80,3,400,415,0.625
3,22,Manufacturer 10,101,9,Retailer 10,95,95,0,6,570,855,0.6666666666666666,75,20,84.75247524752476,-9.752475247524757,508.5148514851486,450,675,0.6666666666666666,75,0,450,450,0.6666666666666666
3,23,Manufacturer 10,113,8,Retailer 10,140,113,27,0,700,1120,0.625,83,57,99.45544554455445,-16.45544554455445,497.27722772277224,415,664,0.625,83,0,415,415,0.625
3,24,Manufacturer 10,104,8,Retailer 10,74,74,0,30,370,592,0.625,83,-9,71.02970297029702,11.970297029702976,355.1485148514851,415,664,0.625,83,0,415,415,0.625
3,25,Manufacturer 10,51,8,Retailer 10,90,51,39,0,450,720,0.625,83,7,81.88118811881188,1.1188118811881225,409.4059405940594,415,664,0.625,51,32,255,415,0.625
3,26,Manufacturer 10,76,9,Retailer 10,100,76,24,0,600,900,0.6666666666666666,75,25,87.37623762376238,-12.376237623762378,524.2574257425742,450,675,0.6666666666666666,75,0,450,450,0.6666666666666666
3,27,Manufacturer 10,73,8,Retailer 10,100,73,27,0,500,800,0.625,83,17,87.37623762376238,-4.376237623762378,436.8811881188119,415,664,0.625,73,10,365,415,0.625
3,28,Manufacturer 10,83,8,Retailer 10,70,70,0,13,350,560,0.625,83,-13,67.92079207920793,15.079207920792072,339.6039603960396,415,664,0.625,83,0,415,415,0.625
3,29,Manufacturer 10,147,8,Retailer 10,82,82,0,65,410,656,0.625,83,-1,76.77227722772277,6.227722772277232,383.86138613861385,415,664,0.625,83,0,415,415,0.625
3,30,Manufacturer 10,115,9,Retailer 10,112,112,0,3,672,1008,0.6666666666666666,75,37,92.66336633663366,-17.663366336633658,555.980198019802,450,675,0.6666666666666666,75,0,450,450,0.6666666666666666
3,31,Manufacturer 10,139,8,Retailer 10,90,90,0,49,450,720,0.625,83,7,81.88118811881188,1.1188118811881225,409.4059405940594,415,664,0.625,83,0,415,415,0.625
3,32,Manufacturer 10,59,8,Retailer 10,67,59,8,0,335,536,0.625,83,-16,65.48514851485149,17.51485148514851,327.42574257425747,415,664,0.625,59,24,295,415,0.625
3,33,Manufacturer 10,122,8,Retailer 10,55,55,0,67,275,440,0.625,83,-28,54.851485148514854,28.148514851485146,274.25742574257424,415,664,0.625,83,0,415,415,0.625
3,34,Manufacturer 10,92,9,Retailer 10,107,92,15,0,642,963,0.6666666666666666,75,32,90.63366336633663,-15.633663366336634,543.8019801980197,450,675,0.6666666666666666,75,0,450,450,0.6666666666666666
3,35,Manufacturer 10,93,8,Retailer 10,125,93,32,0,625,1000,0.625,83,42,96.78217821782178,-13.78217821782178,483.9108910891089,415,664,0.625,83,0,415,415,0.625
3,36,Manufacturer 10,136,8,Retailer 10,110,110,0,26,550,880,0.625,83,27,91.88118811881188,-8.881188118811878,459.4059405940594,415,664,0.625,83,0,415,415,0.625
3,37,Manufacturer 10,116,8,Retailer 10,95,95,0,21,475,760,0.625,83,12,84.75247524752476,-1.7524752475247567,423.7623762376238,415,664,0.625,83,0,415,415,0.625
3,38,Manufacturer 10,105,9,Retailer 10,87,87,0,18,522,783,0.6666666666666666,75,12,80.03960396039604,-5.039603960396036,480.2376237623762,450,675,0.6666666666666666,75,0,450,450,0.6666666666666666
3,39,Manufacturer 10,80,8,Retailer 10,77,77,0,3,385,616,0.625,83,-6,73.25742574257426,9.742574257425744,366.28712871287127,415,664,0.625,80,3,400,415,0.625
3,40,Manufacturer 10,75,9,Retailer 10,112,75,37,0,672,1008,0.6666666666666666,75,37,92.66336633663366,-17.663366336633658,555.980198019802,450,675,0.6666666666666666,75,0,450,450,0.6666666666666666
3,1,Manufacturer 11,122,7,Retailer 11,130,122,8,0,520,910,0.5714285714285714,91,39,97.92079207920793,-6.920792079207928,391.6831683168317,364,637,0.5714285714285714,91,0,364,364,0.5714285714285714
3,2,Manufacturer 11,144,8,Retailer 11,100,100,0,44,500,800,0.625,83,17,87.37623762376238,-4.376237623762378,436.8811881188119,415,664,0.625,83,0,415,415,0.625
3,3,Manufacturer 11,57,9,Retailer 11,51,51,0,6,306,459,0.6666666666666666,75,-24,50.99009900990099,24.009900990099013,305.9405940594059,450,675,0.6666666666666666,57,18,342,450,0.6666666666666666
3,4,Manufacturer 11,149,9,Retailer 11,51,51,0,98,306,459,0.6666666666666666,75,-24,50.99009900990099,24.009900990099013,305.9405940594059,450,675,0.6666666666666666,75,0,450,450,0.6666666666666666
3,5,Manufacturer 11,135,9,Retailer 11,0,0,0,135,0,0,0.0,75,-75,0.0,75.0,0.0,450,675,0.6666666666666666,75,0,450,450,0.6666666666666666
3,6,Manufacturer 11,94,8,Retailer 11,120,94,26,0,600,960,0.625,83,37,95.39603960396039,-12.39603960396039,476.98019801980195,415,664,0.625,83,0,415,415,0.625
3,7,Manufacturer 11,143,8,Retailer 11,130,130,0,13,650,1040,0.625,83,47,97.92079207920793,-14.920792079207928,489.6039603960396,415,664,0.625,83,0,415,415,0.625
3,8,Manufacturer 11,66,8,Retailer 11,90,66,24,0,450,720,0.625,83,7,81.88118811881188,1.1188118811881225,409.4059405940594,415,664,0.625,66,17,330,415,0.625
3,9,Manufacturer 11,123,8,Retailer 11,140,123,17,0,700,1120,0.625,83,57,99.45544554455445,-16.45544554455445,497.27722772277224,415,664,0.625,83,0,415,415,0.625
3,10,Manufacturer 11,73,8,Retailer 11,150,73,77,0,750,1200,0.625,83,67,100.0,-17.0,500.0,415,664,0.625,73,10,365,415,0.625
3,11,Manufacturer 11,142,9,Retailer 11,60,60,0,82,360,540,0.6666666666666666,75,-15,59.45544554455446,15.544554455445542,356.7326732673268,450,675,0.6666666666666666,75,0,450,450,0.6666666666666666
3,12,Manufacturer 11,132,9,Retailer 11,0,0,0,132,0,0,0.0,75,-75,0.0,75.0,0.0,450,675,0.6666666666666666,75,0,450,450,0.6666666666666666
3,13,Manufacturer 11,62,8,Retailer 11,140,62,78,0,700,1120,0.625,83,57,99.45544554455445,-16.45544554455445,497.27722772277224,415,664,0.625,62,21,310,415,0.625
3,14,Manufacturer 11,136,8,Retailer 11,140,136,4,0,700,1120,0.625,83,57,99.45544554455445,-16.45544554455445,497.27722772277224,415,664,0.625,83,0,415,415,0.625
3,15,Manufacturer 11,146,8,Retailer 11,100,100,0,46,500,800,0.625,83,17,87.37623762376238,-4.376237623762378,436.8811881188119,415,664,0.625,83,0,415,415,0.625
3,16,Manufacturer 11,95,7,Retailer 11,150,95,55,0,600,1050,0.5714285714285714,91,59,100.0,-9.0,400.0,364,637,0.5714285714285714,91,0,364,364,0.5714285714285714
3,17,Manufacturer 11,139,7,Retailer 11,150,139,11,0,600,1050,0.5714285714285714,91,59,100.0,-9.0,400.0,364,637,0.5714285714285714,91,0,364,364,0.5714285714285714
3,18,Manufacturer 11,102,8,Retailer 11,90,90,0,12,450,720,0.625,83,7,81.88118811881188,1.1188118811881225,409.4059405940594,415,664,0.625,83,0,415,415,0.625
3,19,Manufacturer 11,83,8,Retailer 11,90,83,7,0,450,720,0.625,83,7,81.88118811881188,1.1188118811881225,409.4059405940594,415,664,0.625,83,0,415,415,0.625
3,20,Manufacturer 11,142,8,Retailer 11,100,100,0,42,500,800,0.625,83,17,87.37623762376238,-4.376237623762378,436.8811881188119,415,664,0.625,83,0,415,415,0.625
3,21,Manufacturer 11,80,8,Retailer 11,120,80,40,0,600,960,0.625,83,37,95.39603960396039,-12.39603960396039,476.98019801980195,415,664,0.625,80,3,400,415,0.625
3,22,Manufacturer 11,101,7,Retailer 11,150,101,49,0,600,1050,0.5714285714285714,91,59,100.0,-9.0,400.0,364,637,0.5714285714285714,91,0,364,364,0.5714285714285714
3,23,Manufacturer 11,113,7,Retailer 11,140,113,27,0,560,980,0.5714285714285714,91,49,99.45544554455445,-8.45544554455445,397.8217821782178,364,637,0.5714285714285714,91,0,364,364,0.5714285714285714
3,24,Manufacturer 11,104,8,Retailer 11,100,100,0,4,500,800,0.625,83,17,87.37623762376238,-4.376237623762378,436.8811881188119,415,664,0.625,83,0,415,415,0.625
3,25,Manufacturer 11,51,8,Retailer 11,90,51,39,0,450,720,0.625,83,7,81.88118811881188,1.1188118811881225,409.4059405940594,415,664,0.625,51,32,255,415,0.625
3,26,Manufacturer 11,76,8,Retailer 11,100,76,24,0,500,800,0.625,83,17,87.37623762376238,-4.376237623762378,436.8811881188119,415,664,0.625,76,7,380,415,0.625
3,27,Manufacturer 11,73,7,Retailer 11,131,73,58,0,524,917,0.5714285714285714,91,40,98.11881188118812,-7.1188118811881225,392.4752475247525,364,637,0.5714285714285714,73,18,292,364,0.5714285714285714
3,28,Manufacturer 11,83,7,Retailer 11,140,83,57,0,560,980,0.5714285714285714,91,49,99.45544554455445,-8.45544554455445,397.8217821782178,364,637,0.5714285714285714,83,8,332,364,0.5714285714285714
3,29,Manufacturer 11,147,8,Retailer 11,120,120,0,27,600,960,0.625,83,37,95.39603960396039,-12.39603960396039,476.98019801980195,415,664,0.625,83,0,415,415,0.625
3,30,Manufacturer 11,115,8,Retailer 11,60,60,0,55,300,480,0.625,83,-23,59.45544554455446,23.544554455445542,297.2772277227723,415,664,0.625,83,0,415,415,0.625
3,31,Manufacturer 11,139,9,Retailer 11,60,60,0,79,360,540,0.6666666666666666,75,-15,59.45544554455446,15.544554455445542,356.7326732673268,450,675,0.6666666666666666,75,0,450,450,0.6666666666666666
3,32,Manufacturer 11,59,8,Retailer 11,100,59,41,0,500,800,0.625,83,17,87.37623762376238,-4.376237623762378,436.8811881188119,415,664,0.625,59,24,295,415,0.625
3,33,Manufacturer 11,122,7,Retailer 11,141,122,19,0,564,987,0.5714285714285714,91,50,99.55445544554455,-8.554455445544548,398.21782178217813,364,637,0.5714285714285714,91,0,364,364,0.5714285714285714
3,34,Manufacturer 11,92,8,Retailer 11,90,90,0,2,450,720,0.625,83,7,81.88118811881188,1.1188118811881225,409.4059405940594,415,664,0.625,83,0,415,415,0.625
3,35,Manufacturer 11,93,8,Retailer 11,90,90,0,3,450,720,0.625,83,7,81.88118811881188,1.1188118811881225,409.4059405940594,415,664,0.625,83,0,415,415,0.625
3,36,Manufacturer 11,136,7,Retailer 11,140,136,4,0,560,980,0.5714285714285714,91,49,99.45544554455445,-8.45544554455445,397.8217821782178,364,637,0.5714285714285714,91,0,364,364,0.5714285714285714
3,37,Manufacturer 11,116,7,Retailer 11,51,51,0,65,204,357,0.5714285714285714,91,-40,50.99009900990099,40.00990099009901,203.96039603960395,364,637,0.5714285714285714,91,0,364,364,0.5714285714285714
3,38,Manufacturer 11,105,9,Retailer 11,51,51,0,54,306,459,0.6666666666666666,75,-24,50.99009900990099,24.009900990099013,305.9405940594059,450,675,0.6666666666666666,75,0,450,450,0.6666666666666666
3,39,Manufacturer 11,80,10,Retailer 11,0,0,0,80,0,0,0.0,66,-66,0.0,66.0,0.0,462,660,0.7,66,0,462,462,0.7
3,40,Manufacturer 11,75,9,Retailer 11,51,51,0,24,306,459,0.6666666666666666,75,-24,50.99009900990099,24.009900990099013,305.9405940594059,450,675,0.6666666666666666,75,0,450,450,0.6666666666666666
3,1,Manufacturer 12,122,7,Retailer 12,93,93,0,29,372,651,0.5714285714285714,91,2,83.63366336633663,7.366336633663366,334.5346534653466,364,637,0.5714285714285714,91,0,364,364,0.5714285714285714
3,2,Manufacturer 12,144,8,Retailer 12,0,0,0,144,0,0,0.0,83,-83,0.0,83.0,0.0,415,664,0.625,83,0,415,415,0.625
3,3,Manufacturer 12,57,7,Retailer 12,123,57,66,0,492,861,0.5714285714285714,91,32,96.25742574257426,-5.257425742574256,385.029702970297,364,637,0.5714285714285714,57,34,228,364,0.5714285714285714
3,4,Manufacturer 12,149,6,Retailer 12,110,110,0,39,330,660,0.5,100,10,91.88118811881188,8.118811881188122,275.6435643564356,300,600,0.5,100,0,300,300,0.5
3,5,Manufacturer 12,135,7,Retailer 12,72,72,0,63,288,504,0.5714285714285714,91,-19,69.4950495049505,21.5049504950495,277.980198019802,364,637,0.5714285714285714,91,0,364,364,0.5714285714285714
3,6,Manufacturer 12,94,7,Retailer 12,113,94,19,0,452,791,0.5714285714285714,91,22,93.03960396039604,-2.039603960396036,372.1584158415842,364,637,0.5714285714285714,91,0,364,364,0.5714285714285714
3,7,Manufacturer 12,143,7,Retailer 12,122,122,0,21,488,854,0.5714285714285714,91,31,95.98019801980197,-4.980198019801975,383.9207920792079,364,637,0.5714285714285714,91,0,364,364,0.5714285714285714
3,8,Manufacturer 12,66,7,Retailer 12,103,66,37,0,412,721,0.5714285714285714,91,12,88.83168316831683,2.168316831683171,355.32673267326726,364,637,0.5714285714285714,66,25,264,364,0.5714285714285714
3,9,Manufacturer 12,123,6,Retailer 12,130,123,7,0,390,780,0.5,100,30,97.92079207920793,2.079207920792072,293.7623762376238,300,600,0.5,100,0,300,300,0.5
3,10,Manufacturer 12,73,7,Retailer 12,83,73,10,0,332,581,0.5714285714285714,91,-8,77.44554455445545,13.554455445544548,309.78217821782187,364,637,0.5714285714285714,73,18,292,364,0.5714285714285714
3,11,Manufacturer 12,142,7,Retailer 12,122,122,0,20,488,854,0.5714285714285714,91,31,95.98019801980197,-4.980198019801975,383.9207920792079,364,637,0.5714285714285714,91,0,364,364,0.5714285714285714
3,12,Manufacturer 12,132,7,Retailer 12,130,130,0,2,520,910,0.5714285714285714,91,39,97.92079207920793,-6.920792079207928,391.6831683168317,364,637,0.5714285714285714,91,0,364,364,0.5714285714285714
3,13,Manufacturer 12,62,8,Retailer 12,80,62,18,0,400,640,0.625,83,-3,75.39603960396039,7.603960396039611,376.98019801980195,415,664,0.625,62,21,310,415,0.625
3,14,Manufacturer 12,136,7,Retailer 12,113,113,0,23,452,791,0.5714285714285714,91,22,93.03960396039604,-2.039603960396036,372.1584158415842,364,637,0.5714285714285714,91,0,364,364,0.5714285714285714
3,15,Manufacturer 12,146,8,Retailer 12,93,93,0,53,465,744,0.625,83,10,83.63366336633663,-0.6336633663366342,418.16831683168317,415,664,0.625,83,0,415,415,0.625
3,16,Manufacturer 12,95,8,Retailer 12,73,73,0,22,365,584,0.625,83,-10,70.26732673267327,12.732673267326732,351.33663366336634,415,664,0.625,83,0,415,415,0.625
3,17,Manufacturer 12,139,8,Retailer 12,67,67,0,72,335,536,0.625,83,-16,65.48514851485149,17.51485148514851,327.42574257425747,415,664,0.625,83,0,415,415,0.625
3,18,Manufacturer 12,102,8,Retailer 12,53,53,0,49,265,424,0.625,83,-30,52.94059405940594,30.05940594059406,264.7029702970297,415,664,0.625,83,0,415,415,0.625
3,19,Manufacturer 12,83,8,Retailer 12,51,51,0,32,255,408,0.625,83,-32,50.99009900990099,32.00990099009901,254.95049504950492,415,664,0.625,83,0,415,415,0.625
3,20,Manufacturer 12,142,7,Retailer 12,130,130,0,12,520,910,0.5714285714285714,91,39,97.92079207920793,-6.920792079207928,391.6831683168317,364,637,0.5714285714285714,91,0,364,364,0.5714285714285714
3,21,Manufacturer 12,80,7,Retailer 12,102,80,22,0,408,714,0.5714285714285714,91,11,88.35643564356435,2.643564356435647,353.42574257425736,364,637,0.5714285714285714,80,11,320,364,0.5714285714285714
3,22,Manufacturer 12,101,7,Retailer 12,97,97,0,4,388,679,0.5714285714285714,91,6,85.83168316831683,5.168316831683171,343.32673267326726,364,637,0.5714285714285714,91,0,364,364,0.5714285714285714
3,23,Manufacturer 12,113,7,Retailer 12,122,113,9,0,488,854,0.5714285714285714,91,31,95.98019801980197,-4.980198019801975,383.9207920792079,364,637,0.5714285714285714,91,0,364,364,0.5714285714285714
3,24,Manufacturer 12,104,7,Retailer 12,83,83,0,21,332,581,0.5714285714285714,91,-8,77.44554455445545,13.554455445544548,309.78217821782187,364,637,0.5714285714285714,91,0,364,364,0.5714285714285714
3,25,Manufacturer 12,51,7,Retailer 12,90,51,39,0,360,630,0.5714285714285714,91,-1,81.88118811881188,9.118811881188122,327.5247524752475,364,637,0.5714285714285714,51,40,204,364,0.5714285714285714
3,26,Manufacturer 12,76,6,Retailer 12,133,76,57,0,399,798,0.5,100,33,98.48514851485149,1.5148514851485118,295.45544554455444,300,600,0.5,76,24,228,300,0.5
3,27,Manufacturer 12,73,6,Retailer 12,132,73,59,0,396,792,0.5,100,32,98.3069306930693,1.6930693069306955,294.9207920792079,300,600,0.5,73,27,219,300,0.5
3,28,Manufacturer 12,83,6,Retailer 12,133,83,50,0,399,798,0.5,100,33,98.48514851485149,1.5148514851485118,295.45544554455444,300,600,0.5,83,17,249,300,0.5
3,29,Manufacturer 12,147,7,Retailer 12,110,110,0,37,440,770,0.5714285714285714,91,19,91.88118811881188,-0.8811881188118775,367.5247524752475,364,637,0.5714285714285714,91,0,364,364,0.5714285714285714
3,30,Manufacturer 12,115,7,Retailer 12,110,110,0,5,440,770,0.5714285714285714,91,19,91.88118811881188,-0.8811881188118775,367.5247524752475,364,637,0.5714285714285714,91,0,364,364,0.5714285714285714
3,31,Manufacturer 12,139,7,Retailer 12,120,120,0,19,480,840,0.5714285714285714,91,29,95.39603960396039,-4.396039603960389,381.58415841584156,364,637,0.5714285714285714,91,0,364,364,0.5714285714285714
3,32,Manufacturer 12,59,8,Retailer 12,53,53,0,6,265,424,0.625,83,-30,52.94059405940594,30.05940594059406,264.7029702970297,415,664,0.625,59,24,295,415,0.625
3,33,Manufacturer 12,122,7,Retailer 12,97,97,0,25,388,679,0.5714285714285714,91,6,85.83168316831683,5.168316831683171,343.32673267326726,364,637,0.5714285714285714,91,0,364,364,0.5714285714285714
3,34,Manufacturer 12,92,7,Retailer 12,98,92,6,0,392,686,0.5714285714285714,91,7,86.35643564356435,4.643564356435647,345.42574257425736,364,637,0.5714285714285714,91,0,364,364,0.5714285714285714
3,35,Manufacturer 12,93,7,Retailer 12,103,93,10,0,412,721,0.5714285714285714,91,12,88.83168316831683,2.168316831683171,355.32673267326726,364,637,0.5714285714285714,91,0,364,364,0.5714285714285714
3,36,Manufacturer 12,136,7,Retailer 12,87,87,0,49,348,609,0.5714285714285714,91,-4,80.03960396039604,10.960396039603964,320.1584158415842,364,637,0.5714285714285714,91,0,364,364,0.5714285714285714
3,37,Manufacturer 12,116,7,Retailer 12,122,116,6,0,488,854,0.5714285714285714,91,31,95.98019801980197,-4.980198019801975,383.9207920792079,364,637,0.5714285714285714,91,0,364,364,0.5714285714285714
3,38,Manufacturer 12,105,7,Retailer 12,103,103,0,2,412,721,0.5714285714285714,91,12,88.83168316831683,2.168316831683171,355.32673267326726,364,637,0.5714285714285714,91,0,364,364,0.5714285714285714
3,39,Manufacturer 12,80,8,Retailer 12,67,67,0,13,335,536,0.625,83,-16,65.48514851485149,17.51485148514851,327.42574257425747,415,664,0.625,80,3,400,415,0.625
3,40,Manufacturer 12,75,7,Retailer 12,112,75,37,0,448,784,0.5714285714285714,91,21,92.66336633663366,-1.6633663366336577,370.65346534653463,364,637,0.5714285714285714,75,16,300,364,0.5714285714285714
3,1,Manufacturer 13,122,6,Retailer 13,100,100,0,22,300,600,0.5,100,0,87.37623762376238,12.623762376237622,262.1287128712871,300,600,0.5,100,0,300,300,0.5
3,2,Manufacturer 13,144,8,Retailer 13,80,80,0,64,400,640,0.625,83,-3,75.39603960396039,7.603960396039611,376.98019801980195,415,664,0.625,83,0,415,415,0.625
3,3,Manufacturer 13,57,8,Retailer 13,80,57,23,0,400,640,0.625,83,-3,75.39603960396039,7.603960396039611,376.98019801980195,415,664,0.625,57,26,285,415,0.625
3,4,Manufacturer 13,149,6,Retailer 13,110,110,0,39,330,660,0.5,100,10,91.88118811881188,8.118811881188122,275.6435643564356,300,600,0.5,100,0,300,300,0.5
3,5,Manufacturer 13,135,9,Retailer 13,55,55,0,80,330,495,0.6666666666666666,75,-20,54.851485148514854,20.148514851485146,329.10891089108907,450,675,0.6666666666666666,75,0,450,450,0.6666666666666666
3,6,Manufacturer 13,94,7,Retailer 13,90,90,0,4,360,630,0.5714285714285714,91,-1,81.88118811881188,9.118811881188122,327.5247524752475,364,637,0.5714285714285714,91,0,364,364,0.5714285714285714
3,7,Manufacturer 13,143,8,Retailer 13,80,80,0,63,400,640,0.625,83,-3,75.39603960396039,7.603960396039611,376.98019801980195,415,664,0.625,83,0,415,415,0.625
3,8,Manufacturer 13,66,6,Retailer 13,110,66,44,0,330,660,0.5,100,10,91.88118811881188,8.118811881188122,275.6435643564356,300,600,0.5,66,34,198,300,0.5
3,9,Manufacturer 13,123,6,Retailer 13,110,110,0,13,330,660,0.5,100,10,91.88118811881188,8.118811881188122,275.6435643564356,300,600,0.5,100,0,300,300,0.5
3,10,Manufacturer 13,73,7,Retailer 13,100,73,27,0,400,700,0.5714285714285714,91,9,87.37623762376238,3.6237623762376217,349.50495049504957,364,637,0.5714285714285714,73,18,292,364,0.5714285714285714
3,11,Manufacturer 13,142,7,Retailer 13,85,85,0,57,340,595,0.5714285714285714,91,-6,78.76237623762377,12.23762376237623,315.049504950495,364,637,0.5714285714285714,91,0,364,364,0.5714285714285714
3,12,Manufacturer 13,132,9,Retailer 13,55,55,0,77,330,495,0.6666666666666666,75,-20,54.851485148514854,20.148514851485146,329.10891089108907,450,675,0.6666666666666666,75,0,450,450,0.6666666666666666
3,13,Manufacturer 13,62,8,Retailer 13,80,62,18,0,400,640,0.625,83,-3,75.39603960396039,7.603960396039611,376.98019801980195,415,664,0.625,62,21,310,415,0.625
3,14,Manufacturer 13,136,8,Retailer 13,80,80,0,56,400,640,0.625,83,-3,75.39603960396039,7.603960396039611,376.98019801980195,415,664,0.625,83,0,415,415,0.625
3,15,Manufacturer 13,146,8,Retailer 13,75,75,0,71,375,600,0.625,83,-8,71.78217821782178,11.21782178217822,358.9108910891089,415,664,0.625,83,0,415,415,0.625
3,16,Manufacturer 13,95,8,Retailer 13,75,75,0,20,375,600,0.625,83,-8,71.78217821782178,11.21782178217822,358.9108910891089,415,664,0.625,83,0,415,415,0.625
3,17,Manufacturer 13,139,7,Retailer 13,90,90,0,49,360,630,0.5714285714285714,91,-1,81.88118811881188,9.118811881188122,327.5247524752475,364,637,0.5714285714285714,91,0,364,364,0.5714285714285714
3,18,Manufacturer 13,102,8,Retailer 13,75,75,0,27,375,600,0.625,83,-8,71.78217821782178,11.21782178217822,358.9108910891089,415,664,0.625,83,0,415,415,0.625
3,19,Manufacturer 13,83,6,Retailer 13,110,83,27,0,330,660,0.5,100,10,91.88118811881188,8.118811881188122,275.6435643564356,300,600,0.5,83,17,249,300,0.5
3,20,Manufacturer 13,142,8,Retailer 13,80,80,0,62,400,640,0.625,83,-3,75.39603960396039,7.603960396039611,376.98019801980195,415,664,0.625,83,0,415,415,0.625
3,21,Manufacturer 13,80,7,Retailer 13,90,80,10,0,360,630,0.5714285714285714,91,-1,81.88118811881188,9.118811881188122,327.5247524752475,364,637,0.5714285714285714,80,11,320,364,0.5714285714285714
3,22,Manufacturer 13,101,7,Retailer 13,90,90,0,11,360,630,0.5714285714285714,91,-1,81.88118811881188,9.118811881188122,327.5247524752475,364,637,0.5714285714285714,91,0,364,364,0.5714285714285714
3,23,Manufacturer 13,113,7,Retailer 13,80,80,0,33,320,560,0.5714285714285714,91,-11,75.39603960396039,15.60396039603961,301.58415841584156,364,637,0.5714285714285714,91,0,364,364,0.5714285714285714
3,24,Manufacturer 13,104,8,Retailer 13,75,75,0,29,375,600,0.625,83,-8,71.78217821782178,11.21782178217822,358.9108910891089,415,664,0.625,83,0,415,415,0.625
3,25,Manufacturer 13,51,7,Retailer 13,80,51,29,0,320,560,0.5714285714285714,91,-11,75.39603960396039,15.60396039603961,301.58415841584156,364,637,0.5714285714285714,51,40,204,364,0.5714285714285714
3,26,Manufacturer 13,76,6,Retailer 13,130,76,54,0,390,780,0.5,100,30,97.92079207920793,2.079207920792072,293.7623762376238,300,600,0.5,76,24,228,300,0.5
3,27,Manufacturer 13,73,7,Retailer 13,100,73,27,0,400,700,0.5714285714285714,91,9,87.37623762376238,3.6237623762376217,349.50495049504957,364,637,0.5714285714285714,73,18,292,364,0.5714285714285714
3,28,Manufacturer 13,83,8,Retailer 13,75,75,0,8,375,600,0.625,83,-8,71.78217821782178,11.21782178217822,358.9108910891089,415,664,0.625,83,0,415,415,0.625
3,29,Manufacturer 13,147,7,Retailer 13,90,90,0,57,360,630,0.5714285714285714,91,-1,81.88118811881188,9.118811881188122,327.5247524752475,364,637,0.5714285714285714,91,0,364,364,0.5714285714285714
3,30,Manufacturer 13,115,8,Retailer 13,90,90,0,25,450,720,0.625,83,7,81.88118811881188,1.1188118811881225,409.4059405940594,415,664,0.625,83,0,415,415,0.625
3,31,Manufacturer 13,139,8,Retailer 13,80,80,0,59,400,640,0.625,83,-3,75.39603960396039,7.603960396039611,376.98019801980195,415,664,0.625,83,0,415,415,0.625
3,32,Manufacturer 13,59,6,Retailer 13,110,59,51,0,330,660,0.5,100,10,91.88118811881188,8.118811881188122,275.6435643564356,300,600,0.5,59,41,177,300,0.5
3,33,Manufacturer 13,122,7,Retailer 13,80,80,0,42,320,560,0.5714285714285714,91,-11,75.39603960396039,15.60396039603961,301.58415841584156,364,637,0.5714285714285714,91,0,364,364,0.5714285714285714
3,34,Manufacturer 13,92,8,Retailer 13,80,80,0,12,400,640,0.625,83,-3,75.39603960396039,7.603960396039611,376.98019801980195,415,664,0.625,83,0,415,415,0.625
3,35,Manufacturer 13,93,7,Retailer 13,90,90,0,3,360,630,0.5714285714285714,91,-1,81.88118811881188,9.118811881188122,327.5247524752475,364,637,0.5714285714285714,91,0,364,364,0.5714285714285714
3,36,Manufacturer 13,136,7,Retailer 13,90,90,0,46,360,630,0.5714285714285714,91,-1,81.88118811881188,9.118811881188122,327.5247524752475,364,637,0.5714285714285714,91,0,364,364,0.5714285714285714
3,37,Manufacturer 13,116,7,Retailer 13,100,100,0,16,400,700,0.5714285714285714,91,9,87.37623762376238,3.6237623762376217,349.50495049504957,364,637,0.5714285714285714,91,0,364,364,0.5714285714285714
3,38,Manufacturer 13,105,8,Retailer 13,80,80,0,25,400,640,0.625,83,-3,75.39603960396039,7.603960396039611,376.98019801980195,415,664,0.625,83,0,415,415,0.625
3,39,Manufacturer 13,80,7,Retailer 13,80,80,0,0,320,560,0.5714285714285714,91,-11,75.39603960396039,15.60396039603961,301.58415841584156,364,637,0.5714285714285714,80,11,320,364,0.5714285714285714
3,40,Manufacturer 13,75,7,Retailer 13,100,75,25,0,400,700,0.5714285714285714,91,9,87.37623762376238,3.6237623762376217,349.50495049504957,364,637,0.5714285714285714,75,16,300,364,0.5714285714285714
4,1,Manufacturer 14,122,8,Retailer 14,90,90,0,32,450,720,0.625,83,7,81.88118811881188,1.1188118811881225,409.4059405940594,415,664,0.625,83,0,415,415,0.625
4,2,Manufacturer 14,144,11,Retailer 14,0,0,0,144,0,0,0.0,58,-58,0.0,58.0,0.0,464,638,0.7272727272727273,58,0,464,464,0.7272727272727273
4,3,Manufacturer 14,57,7,Retailer 14,100,57,43,0,400,700,0.5714285714285714,91,9,87.37623762376238,3.6237623762376217,349.50495049504957,364,637,0.5714285714285714,57,34,228,364,0.5714285714285714
4,4,Manufacturer 14,149,9,Retailer 14,70,70,0,79,420,630,0.6666666666666666,75,-5,67.92079207920793,7.079207920792072,407.5247524752475,450,675,0.6666666666666666,75,0,450,450,0.6666666666666666
4,5,Manufacturer 14,135,10,Retailer 14,0,0,0,135,0,0,0.0,66,-66,0.0,66.0,0.0,462,660,0.7,66,0,462,462,0.7
4,6,Manufacturer 14,94,8,Retailer 14,80,80,0,14,400,640,0.625,83,-3,75.39603960396039,7.603960396039611,376.98019801980195,415,664,0.625,83,0,415,415,0.625
4,7,Manufacturer 14,143,8,Retailer 14,0,0,0,143,0,0,0.0,83,-83,0.0,83.0,0.0,415,664,0.625,83,0,415,415,0.625
4,8,Manufacturer 14,66,8,Retailer 14,0,0,0,66,0,0,0.0,83,-83,0.0,83.0,0.0,415,664,0.625,66,17,330,415,0.625
4,9,Manufacturer 14,123,8,Retailer 14,0,0,0,123,0,0,0.0,83,-83,0.0,83.0,0.0,415,664,0.625,83,0,415,415,0.625
4,10,Manufacturer 14,73,8,Retailer 14,51,51,0,22,255,408,0.625,83,-32,50.99009900990099,32.00990099009901,254.95049504950492,415,664,0.625,73,10,365,415,0.625
4,11,Manufacturer 14,142,8,Retailer 14,60,60,0,82,300,480,0.625,83,-23,59.45544554455446,23.544554455445542,297.2772277227723,415,664,0.625,83,0,415,415,0.625
4,12,Manufacturer 14,132,9,Retailer 14,0,0,0,132,0,0,0.0,75,-75,0.0,75.0,0.0,450,675,0.6666666666666666,75,0,450,450,0.6666666666666666
4,13,Manufacturer 14,62,9,Retailer 14,0,0,0,62,0,0,0.0,75,-75,0.0,75.0,0.0,450,675,0.6666666666666666,62,13,372,450,0.6666666666666666
4,14,Manufacturer 14,136,5,Retailer 14,110,110,0,26,220,550,0.4,108,2,91.88118811881188,16.118811881188122,183.7623762376238,216,540,0.4,108,0,216,216,0.4
4,15,Manufacturer 14,146,8,Retailer 14,60,60,0,86,300,480,0.625,83,-23,59.45544554455446,23.544554455445542,297.2772277227723,415,664,0.625,83,0,415,415,0.625
4,16,Manufacturer 14,95,8,Retailer 14,0,0,0,95,0,0,0.0,83,-83,0.0,83.0,0.0,415,664,0.625,83,0,415,415,0.625
4,17,Manufacturer 14,139,7,Retailer 14,70,70,0,69,280,490,0.5714285714285714,91,-21,67.92079207920793,23.079207920792072,271.6831683168317,364,637,0.5714285714285714,91,0,364,364,0.5714285714285714
4,18,Manufacturer 14,102,7,Retailer 14,60,60,0,42,240,420,0.5714285714285714,91,-31,59.45544554455446,31.544554455445542,237.82178217821786,364,637,0.5714285714285714,91,0,364,364,0.5714285714285714
4,19,Manufacturer 14,83,7,Retailer 14,0,0,0,83,0,0,0.0,91,-91,0.0,91.0,0.0,364,637,0.5714285714285714,83,8,332,364,0.5714285714285714
4,20,Manufacturer 14,142,8,Retailer 14,0,0,0,142,0,0,0.0,83,-83,0.0,83.0,0.0,415,664,0.625,83,0,415,415,0.625
4,21,Manufacturer 14,80,9,Retailer 14,0,0,0,80,0,0,0.0,75,-75,0.0,75.0,0.0,450,675,0.6666666666666666,75,0,450,450,0.6666666666666666
4,22,Manufacturer 14,101,8,Retailer 14,51,51,0,50,255,408,0.625,83,-32,50.99009900990099,32.00990099009901,254.95049504950492,415,664,0.625,83,0,415,415,0.625
4,23,Manufacturer 14,113,5,Retailer 14,130,113,17,0,260,650,0.4,108,22,97.92079207920793,10.079207920792072,195.8415841584158,216,540,0.4,108,0,216,216,0.4
4,24,Manufacturer 14,104,8,Retailer 14,60,60,0,44,300,480,0.625,83,-23,59.45544554455446,23.544554455445542,297.2772277227723,415,664,0.625,83,0,415,415,0.625
4,25,Manufacturer 14,51,6,Retailer 14,110,51,59,0,330,660,0.5,100,10,91.88118811881188,8.118811881188122,275.6435643564356,300,600,0.5,51,49,153,300,0.5
4,26,Manufacturer 14,76,6,Retailer 14,130,76,54,0,390,780,0.5,100,30,97.92079207920793,2.079207920792072,293.7623762376238,300,600,0.5,76,24,228,300,0.5
4,27,Manufacturer 14,73,7,Retailer 14,90,73,17,0,360,630,0.5714285714285714,91,-1,81.88118811881188,9.118811881188122,327.5247524752475,364,637,0.5714285714285714,73,18,292,364,0.5714285714285714
4,28,Manufacturer 14,83,7,Retailer 14,90,83,7,0,360,630,0.5714285714285714,91,-1,81.88118811881188,9.118811881188122,327.5247524752475,364,637,0.5714285714285714,83,8,332,364,0.5714285714285714
4,29,Manufacturer 14,147,8,Retailer 14,51,51,0,96,255,408,0.625,83,-32,50.99009900990099,32.00990099009901,254.95049504950492,415,664,0.625,83,0,415,415,0.625
4,30,Manufacturer 14,115,8,Retailer 14,100,100,0,15,500,800,0.625,83,17,87.37623762376238,-4.376237623762378,436.8811881188119,415,664,0.625,83,0,415,415,0.625
4,31,Manufacturer 14,139,7,Retailer 14,90,90,0,49,360,630,0.5714285714285714,91,-1,81.88118811881188,9.118811881188122,327.5247524752475,364,637,0.5714285714285714,91,0,364,364,0.5714285714285714
4,32,Manufacturer 14,59,7,Retailer 14,70,59,11,0,280,490,0.5714285714285714,91,-21,67.92079207920793,23.079207920792072,271.6831683168317,364,637,0.5714285714285714,59,32,236,364,0.5714285714285714
4,33,Manufacturer 14,122,5,Retailer 14,110,110,0,12,220,550,0.4,108,2,91.88118811881188,16.118811881188122,183.7623762376238,216,540,0.4,108,0,216,216,0.4
4,34,Manufacturer 14,92,8,Retailer 14,70,70,0,22,350,560,0.625,83,-13,67.92079207920793,15.079207920792072,339.6039603960396,415,664,0.625,83,0,415,415,0.625
4,35,Manufacturer 14,93,9,Retailer 14,51,51,0,42,306,459,0.6666666666666666,75,-24,50.99009900990099,24.009900990099013,305.9405940594059,450,675,0.6666666666666666,75,0,450,450,0.6666666666666666
4,36,Manufacturer 14,136,7,Retailer 14,80,80,0,56,320,560,0.5714285714285714,91,-11,75.39603960396039,15.60396039603961,301.58415841584156,364,637,0.5714285714285714,91,0,364,364,0.5714285714285714
4,37,Manufacturer 14,116,6,Retailer 14,120,116,4,0,360,720,0.5,100,20,95.39603960396039,4.603960396039611,286.18811881188117,300,600,0.5,100,0,300,300,0.5
4,38,Manufacturer 14,105,8,Retailer 14,80,80,0,25,400,640,0.625,83,-3,75.39603960396039,7.603960396039611,376.98019801980195,415,664,0.625,83,0,415,415,0.625
4,39,Manufacturer 14,80,8,Retailer 14,60,60,0,20,300,480,0.625,83,-23,59.45544554455446,23.544554455445542,297.2772277227723,415,664,0.625,80,3,400,415,0.625
4,40,Manufacturer 14,75,8,Retailer 14,60,60,0,15,300,480,0.625,83,-23,59.45544554455446,23.544554455445542,297.2772277227723,415,664,0.625,75,8,375,415,0.625
4,1,Manufacturer 15,122,5,Retailer 15,93,93,0,29,186,465,0.4,108,-15,83.63366336633663,24.366336633663366,167.26732673267327,216,540,0.4,108,0,216,216,0.4
4,2,Manufacturer 15,144,8,Retailer 15,80,80,0,64,400,640,0.625,83,-3,75.39603960396039,7.603960396039611,376.98019801980195,415,664,0.625,83,0,415,415,0.625
4,3,Manufacturer 15,57,8,Retailer 15,120,57,63,0,600,960,0.625,83,37,95.39603960396039,-12.39603960396039,476.98019801980195,415,664,0.625,57,26,285,415,0.625
4,4,Manufacturer 15,149,10,Retailer 15,51,51,0,98,357,510,0.7,66,-15,50.99009900990099,15.009900990099013,356.93069306930687,462,660,0.7,66,0,462,462,0.7
4,5,Manufacturer 15,135,9,Retailer 15,75,75,0,60,450,675,0.6666666666666666,75,0,71.78217821782178,3.21782178217822,430.6930693069306,450,675,0.6666666666666666,75,0,450,450,0.6666666666666666
4,6,Manufacturer 15,94,11,Retailer 15,0,0,0,94,0,0,0.0,58,-58,0.0,58.0,0.0,464,638,0.7272727272727273,58,0,464,464,0.7272727272727273
4,7,Manufacturer 15,143,7,Retailer 15,110,110,0,33,440,770,0.5714285714285714,91,19,91.88118811881188,-0.8811881188118775,367.5247524752475,364,637,0.5714285714285714,91,0,364,364,0.5714285714285714
4,8,Manufacturer 15,66,7,Retailer 15,120,66,54,0,480,840,0.5714285714285714,91,29,95.39603960396039,-4.396039603960389,381.58415841584156,364,637,0.5714285714285714,66,25,264,364,0.5714285714285714
4,9,Manufacturer 15,123,8,Retailer 15,90,90,0,33,450,720,0.625,83,7,81.88118811881188,1.1188118811881225,409.4059405940594,415,664,0.625,83,0,415,415,0.625
4,10,Manufacturer 15,73,8,Retailer 15,51,51,0,22,255,408,0.625,83,-32,50.99009900990099,32.00990099009901,254.95049504950492,415,664,0.625,73,10,365,415,0.625
4,11,Manufacturer 15,142,8,Retailer 15,60,60,0,82,300,480,0.625,83,-23,59.45544554455446,23.544554455445542,297.2772277227723,415,664,0.625,83,0,415,415,0.625
4,12,Manufacturer 15,132,4,Retailer 15,130,130,0,2,130,520,0.25,116,14,97.92079207920793,18.079207920792072,97.9207920792079,116,464,0.25,116,0,116,116,0.25
4,13,Manufacturer 15,62,8,Retailer 15,60,60,0,2,300,480,0.625,83,-23,59.45544554455446,23.544554455445542,297.2772277227723,415,664,0.625,62,21,310,415,0.625
4,14,Manufacturer 15,136,7,Retailer 15,100,100,0,36,400,700,0.5714285714285714,91,9,87.37623762376238,3.6237623762376217,349.50495049504957,364,637,0.5714285714285714,91,0,364,364,0.5714285714285714
4,15,Manufacturer 15,146,8,Retailer 15,100,100,0,46,500,800,0.625,83,17,87.37623762376238,-4.376237623762378,436.8811881188119,415,664,0.625,83,0,415,415,0.625
4,16,Manufacturer 15,95,7,Retailer 15,120,95,25,0,480,840,0.5714285714285714,91,29,95.39603960396039,-4.396039603960389,381.58415841584156,364,637,0.5714285714285714,91,0,364,364,0.5714285714285714
4,17,Manufacturer 15,139,3,Retailer 15,150,139,11,0,0,450,0.0,125,25,100.0,25.0,0.0,0,375,0.0,125,0,0,0,0.0
4,18,Manufacturer 15,102,9,Retailer 15,51,51,0,51,306,459,0.6666666666666666,75,-24,50.99009900990099,24.009900990099013,305.9405940594059,450,675,0.6666666666666666,75,0,450,450,0.6666666666666666
4,19,Manufacturer 15,83,8,Retailer 15,80,80,0,3,400,640,0.625,83,-3,75.39603960396039,7.603960396039611,376.98019801980195,415,664,0.625,83,0,415,415,0.625
4,20,Manufacturer 15,142,9,Retailer 15,70,70,0,72,420,630,0.6666666666666666,75,-5,67.92079207920793,7.079207920792072,407.5247524752475,450,675,0.6666666666666666,75,0,450,450,0.6666666666666666
4,21,Manufacturer 15,80,9,Retailer 15,0,0,0,80,0,0,0.0,75,-75,0.0,75.0,0.0,450,675,0.6666666666666666,75,0,450,450,0.6666666666666666
4,22,Manufacturer 15,101,8,Retailer 15,78,78,0,23,390,624,0.625,83,-5,73.98019801980197,9.019801980198025,369.90099009900985,415,664,0.625,83,0,415,415,0.625
4,23,Manufacturer 15,113,7,Retailer 15,120,113,7,0,480,840,0.5714285714285714,91,29,95.39603960396039,-4.396039603960389,381.58415841584156,364,637,0.5714285714285714,91,0,364,364,0.5714285714285714
4,24,Manufacturer 15,104,8,Retailer 15,80,80,0,24,400,640,0.625,83,-3,75.39603960396039,7.603960396039611,376.98019801980195,415,664,0.625,83,0,415,415,0.625
4,25,Manufacturer 15,51,8,Retailer 15,80,51,29,0,400,640,0.625,83,-3,75.39603960396039,7.603960396039611,376.98019801980195,415,664,0.625,51,32,255,415,0.625
4,26,Manufacturer 15,76,8,Retailer 15,51,51,0,25,255,408,0.625,83,-32,50.99009900990099,32.00990099009901,254.95049504950492,415,664,0.625,76,7,380,415,0.625
4,27,Manufacturer 15,73,8,Retailer 15,51,51,0,22,255,408,0.625,83,-32,50.99009900990099,32.00990099009901,254.95049504950492,415,664,0.625,73,10,365,415,0.625
4,28,Manufacturer 15,83,7,Retailer 15,110,83,27,0,440,770,0.5714285714285714,91,19,91.88118811881188,-0.8811881188118775,367.5247524752475,364,637,0.5714285714285714,83,8,332,364,0.5714285714285714
4,29,Manufacturer 15,147,7,Retailer 15,120,120,0,27,480,840,0.5714285714285714,91,29,95.39603960396039,-4.396039603960389,381.58415841584156,364,637,0.5714285714285714,91,0,364,364,0.5714285714285714
4,30,Manufacturer 15,115,8,Retailer 15,51,51,0,64,255,408,0.625,83,-32,50.99009900990099,32.00990099009901,254.95049504950492,415,664,0.625,83,0,415,415,0.625
4,31,Manufacturer 15,139,7,Retailer 15,130,130,0,9,520,910,0.5714285714285714,91,39,97.92079207920793,-6.920792079207928,391.6831683168317,364,637,0.5714285714285714,91,0,364,364,0.5714285714285714
4,32,Manufacturer 15,59,7,Retailer 15,130,59,71,0,520,910,0.5714285714285714,91,39,97.92079207920793,-6.920792079207928,391.6831683168317,364,637,0.5714285714285714,59,32,236,364,0.5714285714285714
4,33,Manufacturer 15,122,8,Retailer 15,61,61,0,61,305,488,0.625,83,-22,60.34653465346535,22.653465346534652,301.73267326732673,415,664,0.625,83,0,415,415,0.625
4,34,Manufacturer 15,92,8,Retailer 15,71,71,0,21,355,568,0.625,83,-12,68.7128712871287,14.287128712871294,343.5643564356435,415,664,0.625,83,0,415,415,0.625
4,35,Manufacturer 15,93,8,Retailer 15,90,90,0,3,450,720,0.625,83,7,81.88118811881188,1.1188118811881225,409.4059405940594,415,664,0.625,83,0,415,415,0.625
4,36,Manufacturer 15,136,8,Retailer 15,80,80,0,56,400,640,0.625,83,-3,75.39603960396039,7.603960396039611,376.98019801980195,415,664,0.625,83,0,415,415,0.625
4,37,Manufacturer 15,116,8,Retailer 15,100,100,0,16,500,800,0.625,83,17,87.37623762376238,-4.376237623762378,436.8811881188119,415,664,0.625,83,0,415,415,0.625
4,38,Manufacturer 15,105,8,Retailer 15,75,75,0,30,375,600,0.625,83,-8,71.78217821782178,11.21782178217822,358.9108910891089,415,664,0.625,83,0,415,415,0.625
4,39,Manufacturer 15,80,9,Retailer 15,51,51,0,29,306,459,0.6666666666666666,75,-24,50.99009900990099,24.009900990099013,305.9405940594059,450,675,0.6666666666666666,75,0,450,450,0.6666666666666666
4,40,Manufacturer 15,75,9,Retailer 15,75,75,0,0,450,675,0.6666666666666666,75,0,71.78217821782178,3.21782178217822,430.6930693069306,450,675,0.6666666666666666,75,0,450,450,0.6666666666666666
4,1,Manufacturer 16,122,7,Retailer 16,95,95,0,27,380,665,0.5714285714285714,91,4,84.75247524752476,6.247524752475243,339.009900990099,364,637,0.5714285714285714,91,0,364,364,0.5714285714285714
4,2,Manufacturer 16,144,8,Retailer 16,85,85,0,59,425,680,0.625,83,2,78.76237623762377,4.237623762376231,393.81188118811883,415,664,0.625,83,0,415,415,0.625
4,3,Manufacturer 16,57,6,Retailer 16,105,57,48,0,315,630,0.5,100,5,89.75247524752476,10.247524752475243,269.25742574257424,300,600,0.5,57,43,171,300,0.5
4,4,Manufacturer 16,149,9,Retailer 16,75,75,0,74,450,675,0.6666666666666666,75,0,71.78217821782178,3.21782178217822,430.6930693069306,450,675,0.6666666666666666,75,0,450,450,0.6666666666666666
4,5,Manufacturer 16,135,8,Retailer 16,85,85,0,50,425,680,0.625,83,2,78.76237623762377,4.237623762376231,393.81188118811883,415,664,0.625,83,0,415,415,0.625
4,6,Manufacturer 16,94,10,Retailer 16,0,0,0,94,0,0,0.0,66,-66,0.0,66.0,0.0,462,660,0.7,66,0,462,462,0.7
4,7,Manufacturer 16,143,7,Retailer 16,110,110,0,33,440,770,0.5714285714285714,91,19,91.88118811881188,-0.8811881188118775,367.5247524752475,364,637,0.5714285714285714,91,0,364,364,0.5714285714285714
4,8,Manufacturer 16,66,9,Retailer 16,92,66,26,0,552,828,0.6666666666666666,75,17,83.05940594059406,-8.059405940594061,498.35643564356434,450,675,0.6666666666666666,66,9,396,450,0.6666666666666666
4,9,Manufacturer 16,123,8,Retailer 16,100,100,0,23,500,800,0.625,83,17,87.37623762376238,-4.376237623762378,436.8811881188119,415,664,0.625,83,0,415,415,0.625
4,10,Manufacturer 16,73,8,Retailer 16,80,73,7,0,400,640,0.625,83,-3,75.39603960396039,7.603960396039611,376.98019801980195,415,664,0.625,73,10,365,415,0.625
4,11,Manufacturer 16,142,7,Retailer 16,110,110,0,32,440,770,0.5714285714285714,91,19,91.88118811881188,-0.8811881188118775,367.5247524752475,364,637,0.5714285714285714,91,0,364,364,0.5714285714285714
4,12,Manufacturer 16,132,9,Retailer 16,85,85,0,47,510,765,0.6666666666666666,75,10,78.76237623762377,-3.7623762376237693,472.57425742574264,450,675,0.6666666666666666,75,0,450,450,0.6666666666666666
4,13,Manufacturer 16,62,8,Retailer 16,80,62,18,0,400,640,0.625,83,-3,75.39603960396039,7.603960396039611,376.98019801980195,415,664,0.625,62,21,310,415,0.625
4,14,Manufacturer 16,136,7,Retailer 16,110,110,0,26,440,770,0.5714285714285714,91,19,91.88118811881188,-0.8811881188118775,367.5247524752475,364,637,0.5714285714285714,91,0,364,364,0.5714285714285714
4,15,Manufacturer 16,146,8,Retailer 16,95,95,0,51,475,760,0.625,83,12,84.75247524752476,-1.7524752475247567,423.7623762376238,415,664,0.625,83,0,415,415,0.625
4,16,Manufacturer 16,95,9,Retailer 16,70,70,0,25,420,630,0.6666666666666666,75,-5,67.92079207920793,7.079207920792072,407.5247524752475,450,675,0.6666666666666666,75,0,450,450,0.6666666666666666
4,17,Manufacturer 16,139,8,Retailer 16,100,100,0,39,500,800,0.625,83,17,87.37623762376238,-4.376237623762378,436.8811881188119,415,664,0.625,83,0,415,415,0.625
4,18,Manufacturer 16,102,9,Retailer 16,70,70,0,32,420,630,0.6666666666666666,75,-5,67.92079207920793,7.079207920792072,407.5247524752475,450,675,0.6666666666666666,75,0,450,450,0.6666666666666666
4,19,Manufacturer 16,83,9,Retailer 16,70,70,0,13,420,630,0.6666666666666666,75,-5,67.92079207920793,7.079207920792072,407.5247524752475,450,675,0.6666666666666666,75,0,450,450,0.6666666666666666
4,20,Manufacturer 16,142,8,Retailer 16,130,130,0,12,650,1040,0.625,83,47,97.92079207920793,-14.920792079207928,489.6039603960396,415,664,0.625,83,0,415,415,0.625
4,21,Manufacturer 16,80,8,Retailer 16,110,80,30,0,550,880,0.625,83,27,91.88118811881188,-8.881188118811878,459.4059405940594,415,664,0.625,80,3,400,415,0.625
4,22,Manufacturer 16,101,9,Retailer 16,0,0,0,101,0,0,0.0,75,-75,0.0,75.0,0.0,450,675,0.6666666666666666,75,0,450,450,0.6666666666666666
4,23,Manufacturer 16,113,8,Retailer 16,75,75,0,38,375,600,0.625,83,-8,71.78217821782178,11.21782178217822,358.9108910891089,415,664,0.625,83,0,415,415,0.625
4,24,Manufacturer 16,104,7,Retailer 16,110,104,6,0,440,770,0.5714285714285714,91,19,91.88118811881188,-0.8811881188118775,367.5247524752475,364,637,0.5714285714285714,91,0,364,364,0.5714285714285714
4,25,Manufacturer 16,51,8,Retailer 16,120,51,69,0,600,960,0.625,83,37,95.39603960396039,-12.39603960396039,476.98019801980195,415,664,0.625,51,32,255,415,0.625
4,26,Manufacturer 16,76,7,Retailer 16,120,76,44,0,480,840,0.5714285714285714,91,29,95.39603960396039,-4.396039603960389,381.58415841584156,364,637,0.5714285714285714,76,15,304,364,0.5714285714285714
4,27,Manufacturer 16,73,8,Retailer 16,110,73,37,0,550,880,0.625,83,27,91.88118811881188,-8.881188118811878,459.4059405940594,415,664,0.625,73,10,365,415,0.625
4,28,Manufacturer 16,83,8,Retailer 16,110,83,27,0,550,880,0.625,83,27,91.88118811881188,-8.881188118811878,459.4059405940594,415,664,0.625,83,0,415,415,0.625
4,29,Manufacturer 16,147,7,Retailer 16,120,120,0,27,480,840,0.5714285714285714,91,29,95.39603960396039,-4.396039603960389,381.58415841584156,364,637,0.5714285714285714,91,0,364,364,0.5714285714285714
4,30,Manufacturer 16,115,8,Retailer 16,90,90,0,25,450,720,0.625,83,7,81.88118811881188,1.1188118811881225,409.4059405940594,415,664,0.625,83,0,415,415,0.625
4,31,Manufacturer 16,139,8,Retailer 16,95,95,0,44,475,760,0.625,83,12,84.75247524752476,-1.7524752475247567,423.7623762376238,415,664,0.625,83,0,415,415,0.625
4,32,Manufacturer 16,59,8,Retailer 16,55,55,0,4,275,440,0.625,83,-28,54.851485148514854,28.148514851485146,274.25742574257424,415,664,0.625,59,24,295,415,0.625
4,33,Manufacturer 16,122,7,Retailer 16,125,122,3,0,500,875,0.5714285714285714,91,34,96.78217821782178,-5.78217821782178,387.1287128712871,364,637,0.5714285714285714,91,0,364,364,0.5714285714285714
4,34,Manufacturer 16,92,8,Retailer 16,61,61,0,31,305,488,0.625,83,-22,60.34653465346535,22.653465346534652,301.73267326732673,415,664,0.625,83,0,415,415,0.625
4,35,Manufacturer 16,93,7,Retailer 16,132,93,39,0,528,924,0.5714285714285714,91,41,98.3069306930693,-7.3069306930693045,393.2277227722773,364,637,0.5714285714285714,91,0,364,364,0.5714285714285714
4,36,Manufacturer 16,136,7,Retailer 16,112,112,0,24,448,784,0.5714285714285714,91,21,92.66336633663366,-1.6633663366336577,370.65346534653463,364,637,0.5714285714285714,91,0,364,364,0.5714285714285714
4,37,Manufacturer 16,116,8,Retailer 16,65,65,0,51,325,520,0.625,83,-18,63.81188118811881,19.18811881188119,319.05940594059405,415,664,0.625,83,0,415,415,0.625
4,38,Manufacturer 16,105,8,Retailer 16,60,60,0,45,300,480,0.625,83,-23,59.45544554455446,23.544554455445542,297.2772277227723,415,664,0.625,83,0,415,415,0.625
4,39,Manufacturer 16,80,8,Retailer 16,68,68,0,12,340,544,0.625,83,-15,66.3069306930693,16.693069306930695,331.53465346534654,415,664,0.625,80,3,400,415,0.625
4,40,Manufacturer 16,75,9,Retailer 16,51,51,0,24,306,459,0.6666666666666666,75,-24,50.99009900990099,24.009900990099013,305.9405940594059,450,675,0.6666666666666666,75,0,450,450,0.6666666666666666
5,1,Manufacturer 17,122,9,Retailer 17,70,70,0,52,420,630,0.6666666666666666,75,-5,67.92079207920793,7.079207920792072,407.5247524752475,450,675,0.6666666666666666,75,0,450,450,0.6666666666666666
5,2,Manufacturer 17,144,10,Retailer 17,0,0,0,144,0,0,0.0,66,-66,0.0,66.0,0.0,462,660,0.7,66,0,462,462,0.7
5,3,Manufacturer 17,57,8,Retailer 17,75,57,18,0,375,600,0.625,83,-8,71.78217821782178,11.21782178217822,358.9108910891089,415,664,0.625,57,26,285,415,0.625
5,4,Manufacturer 17,149,8,Retailer 17,0,0,0,149,0,0,0.0,83,-83,0.0,83.0,0.0,415,664,0.625,83,0,415,415,0.625
5,5,Manufacturer 17,135,8,Retailer 17,51,51,0,84,255,408,0.625,83,-32,50.99009900990099,32.00990099009901,254.95049504950492,415,664,0.625,83,0,415,415,0.625
5,6,Manufacturer 17,94,7,Retailer 17,110,94,16,0,440,770,0.5714285714285714,91,19,91.88118811881188,-0.8811881188118775,367.5247524752475,364,637,0.5714285714285714,91,0,364,364,0.5714285714285714
5,7,Manufacturer 17,143,7,Retailer 17,100,100,0,43,400,700,0.5714285714285714,91,9,87.37623762376238,3.6237623762376217,349.50495049504957,364,637,0.5714285714285714,91,0,364,364,0.5714285714285714
5,8,Manufacturer 17,66,8,Retailer 17,95,66,29,0,475,760,0.625,83,12,84.75247524752476,-1.7524752475247567,423.7623762376238,415,664,0.625,66,17,330,415,0.625
5,9,Manufacturer 17,123,7,Retailer 17,120,120,0,3,480,840,0.5714285714285714,91,29,95.39603960396039,-4.396039603960389,381.58415841584156,364,637,0.5714285714285714,91,0,364,364,0.5714285714285714
5,10,Manufacturer 17,73,8,Retailer 17,111,73,38,0,555,888,0.625,83,28,92.27722772277228,-9.277227722772281,461.3861386138614,415,664,0.625,73,10,365,415,0.625
5,11,Manufacturer 17,142,8,Retailer 17,80,80,0,62,400,640,0.625,83,-3,75.39603960396039,7.603960396039611,376.98019801980195,415,664,0.625,83,0,415,415,0.625
5,12,Manufacturer 17,132,7,Retailer 17,130,130,0,2,520,910,0.5714285714285714,91,39,97.92079207920793,-6.920792079207928,391.6831683168317,364,637,0.5714285714285714,91,0,364,364,0.5714285714285714
5,13,Manufacturer 17,62,9,Retailer 17,55,55,0,7,330,495,0.6666666666666666,75,-20,54.851485148514854,20.148514851485146,329.10891089108907,450,675,0.6666666666666666,62,13,372,450,0.6666666666666666
5,14,Manufacturer 17,136,9,Retailer 17,60,60,0,76,360,540,0.6666666666666666,75,-15,59.45544554455446,15.544554455445542,356.7326732673268,450,675,0.6666666666666666,75,0,450,450,0.6666666666666666
5,15,Manufacturer 17,146,8,Retailer 17,120,120,0,26,600,960,0.625,83,37,95.39603960396039,-12.39603960396039,476.98019801980195,415,664,0.625,83,0,415,415,0.625
5,16,Manufacturer 17,95,8,Retailer 17,85,85,0,10,425,680,0.625,83,2,78.76237623762377,4.237623762376231,393.81188118811883,415,664,0.625,83,0,415,415,0.625
5,17,Manufacturer 17,139,8,Retailer 17,75,75,0,64,375,600,0.625,83,-8,71.78217821782178,11.21782178217822,358.9108910891089,415,664,0.625,83,0,415,415,0.625
5,18,Manufacturer 17,102,9,Retailer 17,85,85,0,17,510,765,0.6666666666666666,75,10,78.76237623762377,-3.7623762376237693,472.57425742574264,450,675,0.6666666666666666,75,0,450,450,0.6666666666666666
5,19,Manufacturer 17,83,9,Retailer 17,55,55,0,28,330,495,0.6666666666666666,75,-20,54.851485148514854,20.148514851485146,329.10891089108907,450,675,0.6666666666666666,75,0,450,450,0.6666666666666666
5,20,Manufacturer 17,142,8,Retailer 17,120,120,0,22,600,960,0.625,83,37,95.39603960396039,-12.39603960396039,476.98019801980195,415,664,0.625,83,0,415,415,0.625
5,21,Manufacturer 17,80,9,Retailer 17,75,75,0,5,450,675,0.6666666666666666,75,0,71.78217821782178,3.21782178217822,430.6930693069306,450,675,0.6666666666666666,75,0,450,450,0.6666666666666666
5,22,Manufacturer 17,101,9,Retailer 17,0,0,0,101,0,0,0.0,75,-75,0.0,75.0,0.0,450,675,0.6666666666666666,75,0,450,450,0.6666666666666666
5,23,Manufacturer 17,113,8,Retailer 17,95,95,0,18,475,760,0.625,83,12,84.75247524752476,-1.7524752475247567,423.7623762376238,415,664,0.625,83,0,415,415,0.625
5,24,Manufacturer 17,104,8,Retailer 17,75,75,0,29,375,600,0.625,83,-8,71.78217821782178,11.21782178217822,358.9108910891089,415,664,0.625,83,0,415,415,0.625
5,25,Manufacturer 17,51,8,Retailer 17,96,51,45,0,480,768,0.625,83,13,85.29702970297029,-2.297029702970292,426.48514851485146,415,664,0.625,51,32,255,415,0.625
5,26,Manufacturer 17,76,7,Retailer 17,115,76,39,0,460,805,0.5714285714285714,91,24,93.76237623762377,-2.7623762376237693,375.049504950495,364,637,0.5714285714285714,76,15,304,364,0.5714285714285714
5,27,Manufacturer 17,73,8,Retailer 17,85,73,12,0,425,680,0.625,83,2,78.76237623762377,4.237623762376231,393.81188118811883,415,664,0.625,73,10,365,415,0.625
5,28,Manufacturer 17,83,8,Retailer 17,98,83,15,0,490,784,0.625,83,15,86.35643564356435,-3.356435643564353,431.78217821782175,415,664,0.625,83,0,415,415,0.625
5,29,Manufacturer 17,147,9,Retailer 17,70,70,0,77,420,630,0.6666666666666666,75,-5,67.92079207920793,7.079207920792072,407.5247524752475,450,675,0.6666666666666666,75,0,450,450,0.6666666666666666
5,30,Manufacturer 17,115,8,Retailer 17,100,100,0,15,500,800,0.625,83,17,87.37623762376238,-4.376237623762378,436.8811881188119,415,664,0.625,83,0,415,415,0.625
5,31,Manufacturer 17,139,8,Retailer 17,90,90,0,49,450,720,0.625,83,7,81.88118811881188,1.1188118811881225,409.4059405940594,415,664,0.625,83,0,415,415,0.625
5,32,Manufacturer 17,59,9,Retailer 17,75,59,16,0,450,675,0.6666666666666666,75,0,71.78217821782178,3.21782178217822,430.6930693069306,450,675,0.6666666666666666,59,16,354,450,0.6666666666666666
5,33,Manufacturer 17,122,8,Retailer 17,85,85,0,37,425,680,0.625,83,2,78.76237623762377,4.237623762376231,393.81188118811883,415,664,0.625,83,0,415,415,0.625
5,34,Manufacturer 17,92,8,Retailer 17,140,92,48,0,700,1120,0.625,83,57,99.45544554455445,-16.45544554455445,497.27722772277224,415,664,0.625,83,0,415,415,0.625
5,35,Manufacturer 17,93,8,Retailer 17,90,90,0,3,450,720,0.625,83,7,81.88118811881188,1.1188118811881225,409.4059405940594,415,664,0.625,83,0,415,415,0.625
5,36,Manufacturer 17,136,8,Retailer 17,95,95,0,41,475,760,0.625,83,12,84.75247524752476,-1.7524752475247567,423.7623762376238,415,664,0.625,83,0,415,415,0.625
5,37,Manufacturer 17,116,7,Retailer 17,120,116,4,0,480,840,0.5714285714285714,91,29,95.39603960396039,-4.396039603960389,381.58415841584156,364,637,0.5714285714285714,91,0,364,364,0.5714285714285714
5,38,Manufacturer 17,105,8,Retailer 17,105,105,0,0,525,840,0.625,83,22,89.75247524752476,-6.752475247524757,448.7623762376238,415,664,0.625,83,0,415,415,0.625
5,39,Manufacturer 17,80,9,Retailer 17,60,60,0,20,360,540,0.6666666666666666,75,-15,59.45544554455446,15.544554455445542,356.7326732673268,450,675,0.6666666666666666,75,0,450,450,0.6666666666666666
5,40,Manufacturer 17,75,8,Retailer 17,80,75,5,0,400,640,0.625,83,-3,75.39603960396039,7.603960396039611,376.98019801980195,415,664,0.625,75,8,375,415,0.625
5,1,Manufacturer 18,122,9,Retailer 18,51,51,0,71,306,459,0.6666666666666666,75,-24,50.99009900990099,24.009900990099013,305.9405940594059,450,675,0.6666666666666666,75,0,450,450,0.6666666666666666
5,2,Manufacturer 18,144,10,Retailer 18,0,0,0,144,0,0,0.0,66,-66,0.0,66.0,0.0,462,660,0.7,66,0,462,462,0.7
5,3,Manufacturer 18,57,10,Retailer 18,0,0,0,57,0,0,0.0,66,-66,0.0,66.0,0.0,462,660,0.7,57,9,399,462,0.7
5,4,Manufacturer 18,149,8,Retailer 18,0,0,0,149,0,0,0.0,83,-83,0.0,83.0,0.0,415,664,0.625,83,0,415,415,0.625
5,5,Manufacturer 18,135,8,Retailer 18,65,65,0,70,325,520,0.625,83,-18,63.81188118811881,19.18811881188119,319.05940594059405,415,664,0.625,83,0,415,415,0.625
5,6,Manufacturer 18,94,9,Retailer 18,0,0,0,94,0,0,0.0,75,-75,0.0,75.0,0.0,450,675,0.6666666666666666,75,0,450,450,0.6666666666666666
5,7,Manufacturer 18,143,9,Retailer 18,0,0,0,143,0,0,0.0,75,-75,0.0,75.0,0.0,450,675,0.6666666666666666,75,0,450,450,0.6666666666666666
5,8,Manufacturer 18,66,9,Retailer 18,0,0,0,66,0,0,0.0,75,-75,0.0,75.0,0.0,450,675,0.6666666666666666,66,9,396,450,0.6666666666666666
5,9,Manufacturer 18,123,9,Retailer 18,0,0,0,123,0,0,0.0,75,-75,0.0,75.0,0.0,450,675,0.6666666666666666,75,0,450,450,0.6666666666666666
5,10,Manufacturer 18,73,7,Retailer 18,130,73,57,0,520,910,0.5714285714285714,91,39,97.92079207920793,-6.920792079207928,391.6831683168317,364,637,0.5714285714285714,73,18,292,364,0.5714285714285714
5,11,Manufacturer 18,142,6,Retailer 18,140,140,0,2,420,840,0.5,100,40,99.45544554455445,0.5445544554455495,298.36633663366337,300,600,0.5,100,0,300,300,0.5
5,12,Manufacturer 18,132,6,Retailer 18,140,132,8,0,420,840,0.5,100,40,99.45544554455445,0.5445544554455495,298.36633663366337,300,600,0.5,100,0,300,300,0.5
5,13,Manufacturer 18,62,6,Retailer 18,135,62,73,0,405,810,0.5,100,35,98.81188118811882,1.188118811881182,296.43564356435644,300,600,0.5,62,38,186,300,0.5
5,14,Manufacturer 18,136,6,Retailer 18,135,135,0,1,405,810,0.5,100,35,98.81188118811882,1.188118811881182,296.43564356435644,300,600,0.5,100,0,300,300,0.5
5,15,Manufacturer 18,146,6,Retailer 18,135,135,0,11,405,810,0.5,100,35,98.81188118811882,1.188118811881182,296.43564356435644,300,600,0.5,100,0,300,300,0.5
5,16,Manufacturer 18,95,6,Retailer 18,135,95,40,0,405,810,0.5,100,35,98.81188118811882,1.188118811881182,296.43564356435644,300,600,0.5,95,5,285,300,0.5
5,17,Manufacturer 18,139,6,Retailer 18,135,135,0,4,405,810,0.5,100,35,98.81188118811882,1.188118811881182,296.43564356435644,300,600,0.5,100,0,300,300,0.5
5,18,Manufacturer 18,102,6,Retailer 18,135,102,33,0,405,810,0.5,100,35,98.81188118811882,1.188118811881182,296.43564356435644,300,600,0.5,100,0,300,300,0.5
5,19,Manufacturer 18,83,6,Retailer 18,135,83,52,0,405,810,0.5,100,35,98.81188118811882,1.188118811881182,296.43564356435644,300,600,0.5,83,17,249,300,0.5
5,20,Manufacturer 18,142,6,Retailer 18,135,135,0,7,405,810,0.5,100,35,98.81188118811882,1.188118811881182,296.43564356435644,300,600,0.5,100,0,300,300,0.5
5,21,Manufacturer 18,80,6,Retailer 18,135,80,55,0,405,810,0.5,100,35,98.81188118811882,1.188118811881182,296.43564356435644,300,600,0.5,80,20,240,300,0.5
5,22,Manufacturer 18,101,6,Retailer 18,135,101,34,0,405,810,0.5,100,35,98.81188118811882,1.188118811881182,296.43564356435644,300,600,0.5,100,0,300,300,0.5
5,23,Manufacturer 18,113,6,Retailer 18,135,113,22,0,405,810,0.5,100,35,98.81188118811882,1.188118811881182,296.43564356435644,300,600,0.5,100,0,300,300,0.5
5,24,Manufacturer 18,104,6,Retailer 18,135,104,31,0,405,810,0.5,100,35,98.81188118811882,1.188118811881182,296.43564356435644,300,600,0.5,100,0,300,300,0.5
5,25,Manufacturer 18,51,6,Retailer 18,135,51,84,0,405,810,0.5,100,35,98.81188118811882,1.188118811881182,296.43564356435644,300,600,0.5,51,49,153,300,0.5
5,26,Manufacturer 18,76,6,Retailer 18,135,76,59,0,405,810,0.5,100,35,98.81188118811882,1.188118811881182,296.43564356435644,300,600,0.5,76,24,228,300,0.5
5,27,Manufacturer 18,73,6,Retailer 18,135,73,62,0,405,810,0.5,100,35,98.81188118811882,1.188118811881182,296.43564356435644,300,600,0.5,73,27,219,300,0.5
5,28,Manufacturer 18,83,5,Retailer 18,145,83,62,0,290,725,0.4,108,37,99.85148514851485,8.148514851485146,199.70297029702965,216,540,0.4,83,25,166,216,0.4
5,29,Manufacturer 18,147,6,Retailer 18,135,135,0,12,405,810,0.5,100,35,98.81188118811882,1.188118811881182,296.43564356435644,300,600,0.5,100,0,300,300,0.5
5,30,Manufacturer 18,115,6,Retailer 18,136,115,21,0,408,816,0.5,100,36,98.96039603960396,1.039603960396036,296.8811881188119,300,600,0.5,100,0,300,300,0.5
5,31,Manufacturer 18,139,6,Retailer 18,135,135,0,4,405,810,0.5,100,35,98.81188118811882,1.188118811881182,296.43564356435644,300,600,0.5,100,0,300,300,0.5
5,32,Manufacturer 18,59,6,Retailer 18,135,59,76,0,405,810,0.5,100,35,98.81188118811882,1.188118811881182,296.43564356435644,300,600,0.5,59,41,177,300,0.5
5,33,Manufacturer 18,122,6,Retailer 18,135,122,13,0,405,810,0.5,100,35,98.81188118811882,1.188118811881182,296.43564356435644,300,600,0.5,100,0,300,300,0.5
5,34,Manufacturer 18,92,6,Retailer 18,135,92,43,0,405,810,0.5,100,35,98.81188118811882,1.188118811881182,296.43564356435644,300,600,0.5,92,8,276,300,0.5
5,35,Manufacturer 18,93,6,Retailer 18,135,93,42,0,405,810,0.5,100,35,98.81188118811882,1.188118811881182,296.43564356435644,300,600,0.5,93,7,279,300,0.5
5,36,Manufacturer 18,136,6,Retailer 18,135,135,0,1,405,810,0.5,100,35,98.81188118811882,1.188118811881182,296.43564356435644,300,600,0.5,100,0,300,300,0.5
5,37,Manufacturer 18,116,6,Retailer 18,135,116,19,0,405,810,0.5,100,35,98.81188118811882,1.188118811881182,296.43564356435644,300,600,0.5,100,0,300,300,0.5
5,38,Manufacturer 18,105,6,Retailer 18,135,105,30,0,405,810,0.5,100,35,98.81188118811882,1.188118811881182,296.43564356435644,300,600,0.5,100,0,300,300,0.5
5,39,Manufacturer 18,80,6,Retailer 18,135,80,55,0,405,810,0.5,100,35,98.81188118811882,1.188118811881182,296.43564356435644,300,600,0.5,80,20,240,300,0.5
5,40,Manufacturer 18,75,7,Retailer 18,120,75,45,0,480,840,0.5714285714285714,91,29,95.39603960396039,-4.396039603960389,381.58415841584156,364,637,0.5714285714285714,75,16,300,364,0.5714285714285714
5,1,Manufacturer 19,122,8,Retailer 19,76,76,0,46,380,608,0.625,83,-7,72.52475247524752,10.475247524752476,362.6237623762376,415,664,0.625,83,0,415,415,0.625
5,2,Manufacturer 19,144,8,Retailer 19,90,90,0,54,450,720,0.625,83,7,81.88118811881188,1.1188118811881225,409.4059405940594,415,664,0.625,83,0,415,415,0.625
5,3,Manufacturer 19,57,8,Retailer 19,90,57,33,0,450,720,0.625,83,7,81.88118811881188,1.1188118811881225,409.4059405940594,415,664,0.625,57,26,285,415,0.625
5,4,Manufacturer 19,149,8,Retailer 19,70,70,0,79,350,560,0.625,83,-13,67.92079207920793,15.079207920792072,339.6039603960396,415,664,0.625,83,0,415,415,0.625
5,5,Manufacturer 19,135,8,Retailer 19,80,80,0,55,400,640,0.625,83,-3,75.39603960396039,7.603960396039611,376.98019801980195,415,664,0.625,83,0,415,415,0.625
5,6,Manufacturer 19,94,8,Retailer 19,76,76,0,18,380,608,0.625,83,-7,72.52475247524752,10.475247524752476,362.6237623762376,415,664,0.625,83,0,415,415,0.625
5,7,Manufacturer 19,143,8,Retailer 19,90,90,0,53,450,720,0.625,83,7,81.88118811881188,1.1188118811881225,409.4059405940594,415,664,0.625,83,0,415,415,0.625
5,8,Manufacturer 19,66,8,Retailer 19,100,66,34,0,500,800,0.625,83,17,87.37623762376238,-4.376237623762378,436.8811881188119,415,664,0.625,66,17,330,415,0.625
5,9,Manufacturer 19,123,8,Retailer 19,76,76,0,47,380,608,0.625,83,-7,72.52475247524752,10.475247524752476,362.6237623762376,415,664,0.625,83,0,415,415,0.625
5,10,Manufacturer 19,73,8,Retailer 19,90,73,17,0,450,720,0.625,83,7,81.88118811881188,1.1188118811881225,409.4059405940594,415,664,0.625,73,10,365,415,0.625
5,11,Manufacturer 19,142,8,Retailer 19,70,70,0,72,350,560,0.625,83,-13,67.92079207920793,15.079207920792072,339.6039603960396,415,664,0.625,83,0,415,415,0.625
5,12,Manufacturer 19,132,8,Retailer 19,76,76,0,56,380,608,0.625,83,-7,72.52475247524752,10.475247524752476,362.6237623762376,415,664,0.625,83,0,415,415,0.625
5,13,Manufacturer 19,62,8,Retailer 19,70,62,8,0,350,560,0.625,83,-13,67.92079207920793,15.079207920792072,339.6039603960396,415,664,0.625,62,21,310,415,0.625
5,14,Manufacturer 19,136,8,Retailer 19,100,100,0,36,500,800,0.625,83,17,87.37623762376238,-4.376237623762378,436.8811881188119,415,664,0.625,83,0,415,415,0.625
5,15,Manufacturer 19,146,8,Retailer 19,120,120,0,26,600,960,0.625,83,37,95.39603960396039,-12.39603960396039,476.98019801980195,415,664,0.625,83,0,415,415,0.625
5,16,Manufacturer 19,95,8,Retailer 19,51,51,0,44,255,408,0.625,83,-32,50.99009900990099,32.00990099009901,254.95049504950492,415,664,0.625,83,0,415,415,0.625
5,17,Manufacturer 19,139,8,Retailer 19,125,125,0,14,625,1000,0.625,83,42,96.78217821782178,-13.78217821782178,483.9108910891089,415,664,0.625,83,0,415,415,0.625
5,18,Manufacturer 19,102,8,Retailer 19,57,57,0,45,285,456,0.625,83,-26,56.722772277227726,26.277227722772274,283.61386138613864,415,664,0.625,83,0,415,415,0.625
5,19,Manufacturer 19,83,8,Retailer 19,125,83,42,0,625,1000,0.625,83,42,96.78217821782178,-13.78217821782178,483.9108910891089,415,664,0.625,83,0,415,415,0.625
5,20,Manufacturer 19,142,8,Retailer 19,0,0,0,142,0,0,0.0,83,-83,0.0,83.0,0.0,415,664,0.625,83,0,415,415,0.625
5,21,Manufacturer 19,80,8,Retailer 19,0,0,0,80,0,0,0.0,83,-83,0.0,83.0,0.0,415,664,0.625,80,3,400,415,0.625
5,22,Manufacturer 19,101,8,Retailer 19,0,0,0,101,0,0,0.0,83,-83,0.0,83.0,0.0,415,664,0.625,83,0,415,415,0.625
5,23,Manufacturer 19,113,8,Retailer 19,0,0,0,113,0,0,0.0,83,-83,0.0,83.0,0.0,415,664,0.625,83,0,415,415,0.625
5,24,Manufacturer 19,104,8,Retailer 19,0,0,0,104,0,0,0.0,83,-83,0.0,83.0,0.0,415,664,0.625,83,0,415,415,0.625
5,25,Manufacturer 19,51,8,Retailer 19,0,0,0,51,0,0,0.0,83,-83,0.0,83.0,0.0,415,664,0.625,51,32,255,415,0.625
5,26,Manufacturer 19,76,7,Retailer 19,80,76,4,0,320,560,0.5714285714285714,91,-11,75.39603960396039,15.60396039603961,301.58415841584156,364,637,0.5714285714285714,76,15,304,364,0.5714285714285714
5,27,Manufacturer 19,73,7,Retailer 19,90,73,17,0,360,630,0.5714285714285714,91,-1,81.88118811881188,9.118811881188122,327.5247524752475,364,637,0.5714285714285714,73,18,292,364,0.5714285714285714
5,28,Manufacturer 19,83,7,Retailer 19,100,83,17,0,400,700,0.5714285714285714,91,9,87.37623762376238,3.6237623762376217,349.50495049504957,364,637,0.5714285714285714,83,8,332,364,0.5714285714285714
5,29,Manufacturer 19,147,7,Retailer 19,100,100,0,47,400,700,0.5714285714285714,91,9,87.37623762376238,3.6237623762376217,349.50495049504957,364,637,0.5714285714285714,91,0,364,364,0.5714285714285714
5,30,Manufacturer 19,115,7,Retailer 19,100,100,0,15,400,700,0.5714285714285714,91,9,87.37623762376238,3.6237623762376217,349.50495049504957,364,637,0.5714285714285714,91,0,364,364,0.5714285714285714
5,31,Manufacturer 19,139,7,Retailer 19,100,100,0,39,400,700,0.5714285714285714,91,9,87.37623762376238,3.6237623762376217,349.50495049504957,364,637,0.5714285714285714,91,0,364,364,0.5714285714285714
5,32,Manufacturer 19,59,7,Retailer 19,100,59,41,0,400,700,0.5714285714285714,91,9,87.37623762376238,3.6237623762376217,349.50495049504957,364,637,0.5714285714285714,59,32,236,364,0.5714285714285714
5,33,Manufacturer 19,122,7,Retailer 19,100,100,0,22,400,700,0.5714285714285714,91,9,87.37623762376238,3.6237623762376217,349.50495049504957,364,637,0.5714285714285714,91,0,364,364,0.5714285714285714
5,34,Manufacturer 19,92,7,Retailer 19,100,92,8,0,400,700,0.5714285714285714,91,9,87.37623762376238,3.6237623762376217,349.50495049504957,364,637,0.5714285714285714,91,0,364,364,0.5714285714285714
5,35,Manufacturer 19,93,7,Retailer 19,100,93,7,0,400,700,0.5714285714285714,91,9,87.37623762376238,3.6237623762376217,349.50495049504957,364,637,0.5714285714285714,91,0,364,364,0.5714285714285714
5,36,Manufacturer 19,136,7,Retailer 19,100,100,0,36,400,700,0.5714285714285714,91,9,87.37623762376238,3.6237623762376217,349.50495049504957,364,637,0.5714285714285714,91,0,364,364,0.5714285714285714
5,37,Manufacturer 19,116,7,Retailer 19,100,100,0,16,400,700,0.5714285714285714,91,9,87.37623762376238,3.6237623762376217,349.50495049504957,364,637,0.5714285714285714,91,0,364,364,0.5714285714285714
5,38,Manufacturer 19,105,7,Retailer 19,100,100,0,5,400,700,0.5714285714285714,91,9,87.37623762376238,3.6237623762376217,349.50495049504957,364,637,0.5714285714285714,91,0,364,364,0.5714285714285714
5,39,Manufacturer 19,80,7,Retailer 19,100,80,20,0,400,700,0.5714285714285714,91,9,87.37623762376238,3.6237623762376217,349.50495049504957,364,637,0.5714285714285714,80,11,320,364,0.5714285714285714
5,40,Manufacturer 19,75,7,Retailer 19,100,75,25,0,400,700,0.5714285714285714,91,9,87.37623762376238,3.6237623762376217,349.50495049504957,364,637,0.5714285714285714,75,16,300,364,0.5714285714285714
5,1,Manufacturer 20,122,7,Retailer 20,90,90,0,32,360,630,0.5714285714285714,91,-1,81.88118811881188,9.118811881188122,327.5247524752475,364,637,0.5714285714285714,91,0,364,364,0.5714285714285714
5,2,Manufacturer 20,144,6,Retailer 20,85,85,0,59,255,510,0.5,100,-15,78.76237623762377,21.23762376237623,236.28712871287132,300,600,0.5,100,0,300,300,0.5
5,3,Manufacturer 20,57,7,Retailer 20,110,57,53,0,440,770,0.5714285714285714,91,19,91.88118811881188,-0.8811881188118775,367.5247524752475,364,637,0.5714285714285714,57,34,228,364,0.5714285714285714
5,4,Manufacturer 20,149,8,Retailer 20,90,90,0,59,450,720,0.625,83,7,81.88118811881188,1.1188118811881225,409.4059405940594,415,664,0.625,83,0,415,415,0.625
5,5,Manufacturer 20,135,8,Retailer 20,110,110,0,25,550,880,0.625,83,27,91.88118811881188,-8.881188118811878,459.4059405940594,415,664,0.625,83,0,415,415,0.625
5,6,Manufacturer 20,94,9,Retailer 20,0,0,0,94,0,0,0.0,75,-75,0.0,75.0,0.0,450,675,0.6666666666666666,75,0,450,450,0.6666666666666666
5,7,Manufacturer 20,143,6,Retailer 20,100,100,0,43,300,600,0.5,100,0,87.37623762376238,12.623762376237622,262.1287128712871,300,600,0.5,100,0,300,300,0.5
5,8,Manufacturer 20,66,7,Retailer 20,85,66,19,0,340,595,0.5714285714285714,91,-6,78.76237623762377,12.23762376237623,315.049504950495,364,637,0.5714285714285714,66,25,264,364,0.5714285714285714
5,9,Manufacturer 20,123,7,Retailer 20,90,90,0,33,360,630,0.5714285714285714,91,-1,81.88118811881188,9.118811881188122,327.5247524752475,364,637,0.5714285714285714,91,0,364,364,0.5714285714285714
5,10,Manufacturer 20,73,6,Retailer 20,115,73,42,0,345,690,0.5,100,15,93.76237623762377,6.237623762376231,281.2871287128713,300,600,0.5,73,27,219,300,0.5
5,11,Manufacturer 20,142,8,Retailer 20,100,100,0,42,500,800,0.625,83,17,87.37623762376238,-4.376237623762378,436.8811881188119,415,664,0.625,83,0,415,415,0.625
5,12,Manufacturer 20,132,8,Retailer 20,120,120,0,12,600,960,0.625,83,37,95.39603960396039,-12.39603960396039,476.98019801980195,415,664,0.625,83,0,415,415,0.625
5,13,Manufacturer 20,62,8,Retailer 20,100,62,38,0,500,800,0.625,83,17,87.37623762376238,-4.376237623762378,436.8811881188119,415,664,0.625,62,21,310,415,0.625
5,14,Manufacturer 20,136,7,Retailer 20,109,109,0,27,436,763,0.5714285714285714,91,18,91.47524752475248,-0.47524752475247567,365.9009900990099,364,637,0.5714285714285714,91,0,364,364,0.5714285714285714
5,15,Manufacturer 20,146,8,Retailer 20,75,75,0,71,375,600,0.625,83,-8,71.78217821782178,11.21782178217822,358.9108910891089,415,664,0.625,83,0,415,415,0.625
5,16,Manufacturer 20,95,7,Retailer 20,105,95,10,0,420,735,0.5714285714285714,91,14,89.75247524752476,1.2475247524752433,359.009900990099,364,637,0.5714285714285714,91,0,364,364,0.5714285714285714
5,17,Manufacturer 20,139,8,Retailer 20,100,100,0,39,500,800,0.625,83,17,87.37623762376238,-4.376237623762378,436.8811881188119,415,664,0.625,83,0,415,415,0.625
5,18,Manufacturer 20,102,9,Retailer 20,0,0,0,102,0,0,0.0,75,-75,0.0,75.0,0.0,450,675,0.6666666666666666,75,0,450,450,0.6666666666666666
5,19,Manufacturer 20,83,6,Retailer 20,115,83,32,0,345,690,0.5,100,15,93.76237623762377,6.237623762376231,281.2871287128713,300,600,0.5,83,17,249,300,0.5
5,20,Manufacturer 20,142,7,Retailer 20,100,100,0,42,400,700,0.5714285714285714,91,9,87.37623762376238,3.6237623762376217,349.50495049504957,364,637,0.5714285714285714,91,0,364,364,0.5714285714285714
5,21,Manufacturer 20,80,7,Retailer 20,110,80,30,0,440,770,0.5714285714285714,91,19,91.88118811881188,-0.8811881188118775,367.5247524752475,364,637,0.5714285714285714,80,11,320,364,0.5714285714285714
5,22,Manufacturer 20,101,8,Retailer 20,75,75,0,26,375,600,0.625,83,-8,71.78217821782178,11.21782178217822,358.9108910891089,415,664,0.625,83,0,415,415,0.625
5,23,Manufacturer 20,113,7,Retailer 20,98,98,0,15,392,686,0.5714285714285714,91,7,86.35643564356435,4.643564356435647,345.42574257425736,364,637,0.5714285714285714,91,0,364,364,0.5714285714285714
5,24,Manufacturer 20,104,7,Retailer 20,105,104,1,0,420,735,0.5714285714285714,91,14,89.75247524752476,1.2475247524752433,359.009900990099,364,637,0.5714285714285714,91,0,364,364,0.5714285714285714
5,25,Manufacturer 20,51,8,Retailer 20,80,51,29,0,400,640,0.625,83,-3,75.39603960396039,7.603960396039611,376.98019801980195,415,664,0.625,51,32,255,415,0.625
5,26,Manufacturer 20,76,8,Retailer 20,76,76,0,0,380,608,0.625,83,-7,72.52475247524752,10.475247524752476,362.6237623762376,415,664,0.625,76,7,380,415,0.625
5,27,Manufacturer 20,73,8,Retailer 20,75,73,2,0,375,600,0.625,83,-8,71.78217821782178,11.21782178217822,358.9108910891089,415,664,0.625,73,10,365,415,0.625
5,28,Manufacturer 20,83,7,Retailer 20,110,83,27,0,440,770,0.5714285714285714,91,19,91.88118811881188,-0.8811881188118775,367.5247524752475,364,637,0.5714285714285714,83,8,332,364,0.5714285714285714
5,29,Manufacturer 20,147,7,Retailer 20,90,90,0,57,360,630,0.5714285714285714,91,-1,81.88118811881188,9.118811881188122,327.5247524752475,364,637,0.5714285714285714,91,0,364,364,0.5714285714285714
5,30,Manufacturer 20,115,7,Retailer 20,110,110,0,5,440,770,0.5714285714285714,91,19,91.88118811881188,-0.8811881188118775,367.5247524752475,364,637,0.5714285714285714,91,0,364,364,0.5714285714285714
5,31,Manufacturer 20,139,8,Retailer 20,80,80,0,59,400,640,0.625,83,-3,75.39603960396039,7.603960396039611,376.98019801980195,415,664,0.625,83,0,415,415,0.625
5,32,Manufacturer 20,59,6,Retailer 20,120,59,61,0,360,720,0.5,100,20,95.39603960396039,4.603960396039611,286.18811881188117,300,600,0.5,59,41,177,300,0.5
5,33,Manufacturer 20,122,7,Retailer 20,102,102,0,20,408,714,0.5714285714285714,91,11,88.35643564356435,2.643564356435647,353.42574257425736,364,637,0.5714285714285714,91,0,364,364,0.5714285714285714
5,34,Manufacturer 20,92,7,Retailer 20,95,92,3,0,380,665,0.5714285714285714,91,4,84.75247524752476,6.247524752475243,339.009900990099,364,637,0.5714285714285714,91,0,364,364,0.5714285714285714
5,35,Manufacturer 20,93,8,Retailer 20,75,75,0,18,375,600,0.625,83,-8,71.78217821782178,11.21782178217822,358.9108910891089,415,664,0.625,83,0,415,415,0.625
5,36,Manufacturer 20,136,8,Retailer 20,76,76,0,60,380,608,0.625,83,-7,72.52475247524752,10.475247524752476,362.6237623762376,415,664,0.625,83,0,415,415,0.625
5,37,Manufacturer 20,116,7,Retailer 20,120,116,4,0,480,840,0.5714285714285714,91,29,95.39603960396039,-4.396039603960389,381.58415841584156,364,637,0.5714285714285714,91,0,364,364,0.5714285714285714
5,38,Manufacturer 20,105,7,Retailer 20,108,105,3,0,432,756,0.5714285714285714,91,17,91.05940594059406,-0.059405940594061235,364.23762376237624,364,637,0.5714285714285714,91,0,364,364,0.5714285714285714
5,39,Manufacturer 20,80,8,Retailer 20,100,80,20,0,500,800,0.625,83,17,87.37623762376238,-4.376237623762378,436.8811881188119,415,664,0.625,80,3,400,415,0.625
5,40,Manufacturer 20,75,8,Retailer 20,75,75,0,0,375,600,0.625,83,-8,71.78217821782178,11.21782178217822,358.9108910891089,415,664,0.625,75,8,375,415,0.625
5,1,Manufacturer 21,122,7,Retailer 21,99,99,0,23,396,693,0.5714285714285714,91,8,86.87128712871286,4.128712871287135,347.48514851485146,364,637,0.5714285714285714,91,0,364,364,0.5714285714285714
5,2,Manufacturer 21,144,7,Retailer 21,99,99,0,45,396,693,0.5714285714285714,91,8,86.87128712871286,4.128712871287135,347.48514851485146,364,637,0.5714285714285714,91,0,364,364,0.5714285714285714
5,3,Manufacturer 21,57,6,Retailer 21,110,57,53,0,330,660,0.5,100,10,91.88118811881188,8.118811881188122,275.6435643564356,300,600,0.5,57,43,171,300,0.5
5,4,Manufacturer 21,149,7,Retailer 21,99,99,0,50,396,693,0.5714285714285714,91,8,86.87128712871286,4.128712871287135,347.48514851485146,364,637,0.5714285714285714,91,0,364,364,0.5714285714285714
5,5,Manufacturer 21,135,7,Retailer 21,99,99,0,36,396,693,0.5714285714285714,91,8,86.87128712871286,4.128712871287135,347.48514851485146,364,637,0.5714285714285714,91,0,364,364,0.5714285714285714
5,6,Manufacturer 21,94,8,Retailer 21,75,75,0,19,375,600,0.625,83,-8,71.78217821782178,11.21782178217822,358.9108910891089,415,664,0.625,83,0,415,415,0.625
5,7,Manufacturer 21,143,8,Retailer 21,99,99,0,44,495,792,0.625,83,16,86.87128712871286,-3.871287128712865,434.35643564356434,415,664,0.625,83,0,415,415,0.625
5,8,Manufacturer 21,66,8,Retailer 21,99,66,33,0,495,792,0.625,83,16,86.87128712871286,-3.871287128712865,434.35643564356434,415,664,0.625,66,17,330,415,0.625
5,9,Manufacturer 21,123,8,Retailer 21,99,99,0,24,495,792,0.625,83,16,86.87128712871286,-3.871287128712865,434.35643564356434,415,664,0.625,83,0,415,415,0.625
5,10,Manufacturer 21,73,7,Retailer 21,99,73,26,0,396,693,0.5714285714285714,91,8,86.87128712871286,4.128712871287135,347.48514851485146,364,637,0.5714285714285714,73,18,292,364,0.5714285714285714
5,11,Manufacturer 21,142,9,Retailer 21,0,0,0,142,0,0,0.0,75,-75,0.0,75.0,0.0,450,675,0.6666666666666666,75,0,450,450,0.6666666666666666
5,12,Manufacturer 21,132,8,Retailer 21,99,99,0,33,495,792,0.625,83,16,86.87128712871286,-3.871287128712865,434.35643564356434,415,664,0.625,83,0,415,415,0.625
5,13,Manufacturer 21,62,8,Retailer 21,99,62,37,0,495,792,0.625,83,16,86.87128712871286,-3.871287128712865,434.35643564356434,415,664,0.625,62,21,310,415,0.625
5,14,Manufacturer 21,136,7,Retailer 21,99,99,0,37,396,693,0.5714285714285714,91,8,86.87128712871286,4.128712871287135,347.48514851485146,364,637,0.5714285714285714,91,0,364,364,0.5714285714285714
5,15,Manufacturer 21,146,8,Retailer 21,99,99,0,47,495,792,0.625,83,16,86.87128712871286,-3.871287128712865,434.35643564356434,415,664,0.625,83,0,415,415,0.625
5,16,Manufacturer 21,95,9,Retailer 21,0,0,0,95,0,0,0.0,75,-75,0.0,75.0,0.0,450,675,0.6666666666666666,75,0,450,450,0.6666666666666666
5,17,Manufacturer 21,139,8,Retailer 21,99,99,0,40,495,792,0.625,83,16,86.87128712871286,-3.871287128712865,434.35643564356434,415,664,0.625,83,0,415,415,0.625
5,18,Manufacturer 21,102,8,Retailer 21,99,99,0,3,495,792,0.625,83,16,86.87128712871286,-3.871287128712865,434.35643564356434,415,664,0.625,83,0,415,415,0.625
5,19,Manufacturer 21,83,8,Retailer 21,70,70,0,13,350,560,0.625,83,-13,67.92079207920793,15.079207920792072,339.6039603960396,415,664,0.625,83,0,415,415,0.625
5,20,Manufacturer 21,142,8,Retailer 21,130,130,0,12,650,1040,0.625,83,47,97.92079207920793,-14.920792079207928,489.6039603960396,415,664,0.625,83,0,415,415,0.625
5,21,Manufacturer 21,80,8,Retailer 21,99,80,19,0,495,792,0.625,83,16,86.87128712871286,-3.871287128712865,434.35643564356434,415,664,0.625,80,3,400,415,0.625
5,22,Manufacturer 21,101,7,Retailer 21,130,101,29,0,520,910,0.5714285714285714,91,39,97.92079207920793,-6.920792079207928,391.6831683168317,364,637,0.5714285714285714,91,0,364,364,0.5714285714285714
5,23,Manufacturer 21,113,8,Retailer 21,99,99,0,14,495,792,0.625,83,16,86.87128712871286,-3.871287128712865,434.35643564356434,415,664,0.625,83,0,415,415,0.625
5,24,Manufacturer 21,104,8,Retailer 21,75,75,0,29,375,600,0.625,83,-8,71.78217821782178,11.21782178217822,358.9108910891089,415,664,0.625,83,0,415,415,0.625
5,25,Manufacturer 21,51,8,Retailer 21,99,51,48,0,495,792,0.625,83,16,86.87128712871286,-3.871287128712865,434.35643564356434,415,664,0.625,51,32,255,415,0.625
5,26,Manufacturer 21,76,8,Retailer 21,130,76,54,0,650,1040,0.625,83,47,97.92079207920793,-14.920792079207928,489.6039603960396,415,664,0.625,76,7,380,415,0.625
5,27,Manufacturer 21,73,7,Retailer 21,130,73,57,0,520,910,0.5714285714285714,91,39,97.92079207920793,-6.920792079207928,391.6831683168317,364,637,0.5714285714285714,73,18,292,364,0.5714285714285714
5,28,Manufacturer 21,83,7,Retailer 21,140,83,57,0,560,980,0.5714285714285714,91,49,99.45544554455445,-8.45544554455445,397.8217821782178,364,637,0.5714285714285714,83,8,332,364,0.5714285714285714
5,29,Manufacturer 21,147,7,Retailer 21,140,140,0,7,560,980,0.5714285714285714,91,49,99.45544554455445,-8.45544554455445,397.8217821782178,364,637,0.5714285714285714,91,0,364,364,0.5714285714285714
5,30,Manufacturer 21,115,8,Retailer 21,125,115,10,0,625,1000,0.625,83,42,96.78217821782178,-13.78217821782178,483.9108910891089,415,664,0.625,83,0,415,415,0.625
5,31,Manufacturer 21,139,8,Retailer 21,99,99,0,40,495,792,0.625,83,16,86.87128712871286,-3.871287128712865,434.35643564356434,415,664,0.625,83,0,415,415,0.625
5,32,Manufacturer 21,59,8,Retailer 21,75,59,16,0,375,600,0.625,83,-8,71.78217821782178,11.21782178217822,358.9108910891089,415,664,0.625,59,24,295,415,0.625
5,33,Manufacturer 21,122,9,Retailer 21,0,0,0,122,0,0,0.0,75,-75,0.0,75.0,0.0,450,675,0.6666666666666666,75,0,450,450,0.6666666666666666
5,34,Manufacturer 21,92,8,Retailer 21,99,92,7,0,495,792,0.625,83,16,86.87128712871286,-3.871287128712865,434.35643564356434,415,664,0.625,83,0,415,415,0.625
5,35,Manufacturer 21,93,8,Retailer 21,99,93,6,0,495,792,0.625,83,16,86.87128712871286,-3.871287128712865,434.35643564356434,415,664,0.625,83,0,415,415,0.625
5,36,Manufacturer 21,136,8,Retailer 21,99,99,0,37,495,792,0.625,83,16,86.87128712871286,-3.871287128712865,434.35643564356434,415,664,0.625,83,0,415,415,0.625
5,37,Manufacturer 21,116,8,Retailer 21,99,99,0,17,495,792,0.625,83,16,86.87128712871286,-3.871287128712865,434.35643564356434,415,664,0.625,83,0,415,415,0.625
5,38,Manufacturer 21,105,8,Retailer 21,99,99,0,6,495,792,0.625,83,16,86.87128712871286,-3.871287128712865,434.35643564356434,415,664,0.625,83,0,415,415,0.625
5,39,Manufacturer 21,80,8,Retailer 21,99,80,19,0,495,792,0.625,83,16,86.87128712871286,-3.871287128712865,434.35643564356434,415,664,0.625,80,3,400,415,0.625
5,40,Manufacturer 21,75,7,Retailer 21,99,75,24,0,396,693,0.5714285714285714,91,8,86.87128712871286,4.128712871287135,347.48514851485146,364,637,0.5714285714285714,75,16,300,364,0.5714285714285714
5,1,Manufacturer 22,122,6,Retailer 22,75,75,0,47,225,450,0.5,100,-25,71.78217821782178,28.21782178217822,215.34653465346534,300,600,0.5,100,0,300,300,0.5
5,2,Manufacturer 22,144,6,Retailer 22,68,68,0,76,204,408,0.5,100,-32,66.3069306930693,33.693069306930695,198.9207920792079,300,600,0.5,100,0,300,300,0.5
5,3,Manufacturer 22,57,7,Retailer 22,65,57,8,0,260,455,0.5714285714285714,91,-26,63.81188118811881,27.18811881188119,255.24752475247521,364,637,0.5714285714285714,57,34,228,364,0.5714285714285714
5,4,Manufacturer 22,149,7,Retailer 22,58,58,0,91,232,406,0.5714285714285714,91,-33,57.64356435643565,33.35643564356435,230.5742574257426,364,637,0.5714285714285714,91,0,364,364,0.5714285714285714
5,5,Manufacturer 22,135,7,Retailer 22,80,80,0,55,320,560,0.5714285714285714,91,-11,75.39603960396039,15.60396039603961,301.58415841584156,364,637,0.5714285714285714,91,0,364,364,0.5714285714285714
5,6,Manufacturer 22,94,7,Retailer 22,80,80,0,14,320,560,0.5714285714285714,91,-11,75.39603960396039,15.60396039603961,301.58415841584156,364,637,0.5714285714285714,91,0,364,364,0.5714285714285714
5,7,Manufacturer 22,143,7,Retailer 22,60,60,0,83,240,420,0.5714285714285714,91,-31,59.45544554455446,31.544554455445542,237.82178217821786,364,637,0.5714285714285714,91,0,364,364,0.5714285714285714
5,8,Manufacturer 22,66,7,Retailer 22,0,0,0,66,0,0,0.0,91,-91,0.0,91.0,0.0,364,637,0.5714285714285714,66,25,264,364,0.5714285714285714
5,9,Manufacturer 22,123,7,Retailer 22,0,0,0,123,0,0,0.0,91,-91,0.0,91.0,0.0,364,637,0.5714285714285714,91,0,364,364,0.5714285714285714
5,10,Manufacturer 22,73,7,Retailer 22,0,0,0,73,0,0,0.0,91,-91,0.0,91.0,0.0,364,637,0.5714285714285714,73,18,292,364,0.5714285714285714
5,11,Manufacturer 22,142,7,Retailer 22,51,51,0,91,204,357,0.5714285714285714,91,-40,50.99009900990099,40.00990099009901,203.96039603960395,364,637,0.5714285714285714,91,0,364,364,0.5714285714285714
5,12,Manufacturer 22,132,7,Retailer 22,51,51,0,81,204,357,0.5714285714285714,91,-40,50.99009900990099,40.00990099009901,203.96039603960395,364,637,0.5714285714285714,91,0,364,364,0.5714285714285714
5,13,Manufacturer 22,62,7,Retailer 22,51,51,0,11,204,357,0.5714285714285714,91,-40,50.99009900990099,40.00990099009901,203.96039603960395,364,637,0.5714285714285714,62,29,248,364,0.5714285714285714
5,14,Manufacturer 22,136,8,Retailer 22,51,51,0,85,255,408,0.625,83,-32,50.99009900990099,32.00990099009901,254.95049504950492,415,664,0.625,83,0,415,415,0.625
5,15,Manufacturer 22,146,8,Retailer 22,51,51,0,95,255,408,0.625,83,-32,50.99009900990099,32.00990099009901,254.95049504950492,415,664,0.625,83,0,415,415,0.625
5,16,Manufacturer 22,95,9,Retailer 22,0,0,0,95,0,0,0.0,75,-75,0.0,75.0,0.0,450,675,0.6666666666666666,75,0,450,450,0.6666666666666666
5,17,Manufacturer 22,139,8,Retailer 22,55,55,0,84,275,440,0.625,83,-28,54.851485148514854,28.148514851485146,274.25742574257424,415,664,0.625,83,0,415,415,0.625
5,18,Manufacturer 22,102,8,Retailer 22,80,80,0,22,400,640,0.625,83,-3,75.39603960396039,7.603960396039611,376.98019801980195,415,664,0.625,83,0,415,415,0.625
5,19,Manufacturer 22,83,8,Retailer 22,80,80,0,3,400,640,0.625,83,-3,75.39603960396039,7.603960396039611,376.98019801980195,415,664,0.625,83,0,415,415,0.625
5,20,Manufacturer 22,142,8,Retailer 22,80,80,0,62,400,640,0.625,83,-3,75.39603960396039,7.603960396039611,376.98019801980195,415,664,0.625,83,0,415,415,0.625
5,21,Manufacturer 22,80,8,Retailer 22,80,80,0,0,400,640,0.625,83,-3,75.39603960396039,7.603960396039611,376.98019801980195,415,664,0.625,80,3,400,415,0.625
5,22,Manufacturer 22,101,8,Retailer 22,80,80,0,21,400,640,0.625,83,-3,75.39603960396039,7.603960396039611,376.98019801980195,415,664,0.625,83,0,415,415,0.625
5,23,Manufacturer 22,113,8,Retailer 22,80,80,0,33,400,640,0.625,83,-3,75.39603960396039,7.603960396039611,376.98019801980195,415,664,0.625,83,0,415,415,0.625
5,24,Manufacturer 22,104,9,Retailer 22,0,0,0,104,0,0,0.0,75,-75,0.0,75.0,0.0,450,675,0.6666666666666666,75,0,450,450,0.6666666666666666
5,25,Manufacturer 22,51,9,Retailer 22,0,0,0,51,0,0,0.0,75,-75,0.0,75.0,0.0,450,675,0.6666666666666666,51,24,306,450,0.6666666666666666
5,26,Manufacturer 22,76,9,Retailer 22,0,0,0,76,0,0,0.0,75,-75,0.0,75.0,0.0,450,675,0.6666666666666666,75,0,450,450,0.6666666666666666
5,27,Manufacturer 22,73,9,Retailer 22,0,0,0,73,0,0,0.0,75,-75,0.0,75.0,0.0,450,675,0.6666666666666666,73,2,438,450,0.6666666666666666
5,28,Manufacturer 22,83,8,Retailer 22,80,80,0,3,400,640,0.625,83,-3,75.39603960396039,7.603960396039611,376.98019801980195,415,664,0.625,83,0,415,415,0.625
5,29,Manufacturer 22,147,8,Retailer 22,51,51,0,96,255,408,0.625,83,-32,50.99009900990099,32.00990099009901,254.95049504950492,415,664,0.625,83,0,415,415,0.625
5,30,Manufacturer 22,115,8,Retailer 22,51,51,0,64,255,408,0.625,83,-32,50.99009900990099,32.00990099009901,254.95049504950492,415,664,0.625,83,0,415,415,0.625
5,31,Manufacturer 22,139,8,Retailer 22,51,51,0,88,255,408,0.625,83,-32,50.99009900990099,32.00990099009901,254.95049504950492,415,664,0.625,83,0,415,415,0.625
5,32,Manufacturer 22,59,7,Retailer 22,90,59,31,0,360,630,0.5714285714285714,91,-1,81.88118811881188,9.118811881188122,327.5247524752475,364,637,0.5714285714285714,59,32,236,364,0.5714285714285714
5,33,Manufacturer 22,122,7,Retailer 22,90,90,0,32,360,630,0.5714285714285714,91,-1,81.88118811881188,9.118811881188122,327.5247524752475,364,637,0.5714285714285714,91,0,364,364,0.5714285714285714
5,34,Manufacturer 22,92,8,Retailer 22,51,51,0,41,255,408,0.625,83,-32,50.99009900990099,32.00990099009901,254.95049504950492,415,664,0.625,83,0,415,415,0.625
5,35,Manufacturer 22,93,8,Retailer 22,0,0,0,93,0,0,0.0,83,-83,0.0,83.0,0.0,415,664,0.625,83,0,415,415,0.625
5,36,Manufacturer 22,136,8,Retailer 22,0,0,0,136,0,0,0.0,83,-83,0.0,83.0,0.0,415,664,0.625,83,0,415,415,0.625
5,37,Manufacturer 22,116,11,Retailer 22,0,0,0,116,0,0,0.0,58,-58,0.0,58.0,0.0,464,638,0.7272727272727273,58,0,464,464,0.7272727272727273
5,38,Manufacturer 22,105,8,Retailer 22,51,51,0,54,255,408,0.625,83,-32,50.99009900990099,32.00990099009901,254.95049504950492,415,664,0.625,83,0,415,415,0.625
5,39,Manufacturer 22,80,9,Retailer 22,0,0,0,80,0,0,0.0,75,-75,0.0,75.0,0.0,450,675,0.6666666666666666,75,0,450,450,0.6666666666666666
5,40,Manufacturer 22,75,9,Retailer 22,0,0,0,75,0,0,0.0,75,-75,0.0,75.0,0.0,450,675,0.6666666666666666,75,0,450,450,0.6666666666666666
